1		ᇂ
2		ᆻ
3		ᆸ
4		ㅛ
5		ㅠ
6		ㅑ
7		ㅖ
8		ㅢ
9		ㅜ
0		ㅋ
!		ᆩ
"		ᆰ
#		ᆽ
$		ᆵ
%		ᆴ
&		=
=		*
~		+
q		ᆺ
w		ᆯ
e		ㅕ
r		ㅐ
t		ㅓ
y		ㄹ
u		ㄷ
i		ㅁ
o		ㅊ
p		ㅍ
Q		ᇁ
W		ᇀ
E		ᆬ
R		ᆶ
T		ᆳ
Y		五
U		六
I		七
O		八
P		九
{		『
a		ᆼ
s		ᆫ
d		ㅣ
f		ㅏ
g		ㅡ
h		ㄴ
j		ㅇ
k		ㄱ
l		ㅈ
;		ㅂ
:		ㅌ
A		ᆮ
S		ᆭ
D		ᆲ
F		ᆱ
G		ㅒ
H		〇
J		一
K		二
L		三
+		四
*		·
}		』
z		ᆷ
x		ᆨ
c		ㅔ
v		ㅗ
b		ㅜ
n		ㅅ
m		ㅎ
/		ㅗ
Z		ᆾ
X		ᆹ
C		ᆿ
V		ᆪ
B		？
N		“
M		”
?		！
ㄱ/		고
ㄱ4		교
ㄱ5		규
ㄱ6		갸
ㄱ7		계
ㄱ8		긔
ㄱ9		구
ㄱG		걔
ㄱb		구
ㄱc		게
ㄱd		기
ㄱe		겨
ㄱf		가
ㄱg		그
ㄱk		ㄲ
ㄱr		개
ㄱt		거
ㄱv		고
ㄲ/		꼬
ㄲ4		꾜
ㄲ5		뀨
ㄲ6		꺄
ㄲ7		꼐
ㄲ8		끠
ㄲ9		꾸
ㄲG		꺠
ㄲb		꾸
ㄲc		께
ㄲd		끼
ㄲe		껴
ㄲf		까
ㄲg		끄
ㄲr		깨
ㄲt		꺼
ㄲv		꼬
ㄴ/		노
ㄴ4		뇨
ㄴ5		뉴
ㄴ6		냐
ㄴ7		녜
ㄴ8		늬
ㄴ9		누
ㄴG		냬
ㄴb		누
ㄴc		네
ㄴd		니
ㄴe		녀
ㄴf		나
ㄴg		느
ㄴr		내
ㄴt		너
ㄴv		노
ㄷ/		도
ㄷ4		됴
ㄷ5		듀
ㄷ6		댜
ㄷ7		뎨
ㄷ8		듸
ㄷ9		두
ㄷG		댸
ㄷb		두
ㄷc		데
ㄷd		디
ㄷe		뎌
ㄷf		다
ㄷg		드
ㄷr		대
ㄷt		더
ㄷu		ㄸ
ㄷv		도
ㄸ/		또
ㄸ4		뚀
ㄸ5		뜌
ㄸ6		땨
ㄸ7		뗴
ㄸ8		띄
ㄸ9		뚜
ㄸG		떄
ㄸb		뚜
ㄸc		떼
ㄸd		띠
ㄸe		뗘
ㄸf		따
ㄸg		뜨
ㄸr		때
ㄸt		떠
ㄸv		또
ㄹ/		로
ㄹ4		료
ㄹ5		류
ㄹ6		랴
ㄹ7		례
ㄹ8		릐
ㄹ9		루
ㄹG		럐
ㄹb		루
ㄹc		레
ㄹd		리
ㄹe		려
ㄹf		라
ㄹg		르
ㄹr		래
ㄹt		러
ㄹv		로
ㅁ/		모
ㅁ4		묘
ㅁ5		뮤
ㅁ6		먀
ㅁ7		몌
ㅁ8		믜
ㅁ9		무
ㅁG		먜
ㅁb		무
ㅁc		메
ㅁd		미
ㅁe		며
ㅁf		마
ㅁg		므
ㅁr		매
ㅁt		머
ㅁv		모
ㅂ/		보
ㅂ4		뵤
ㅂ5		뷰
ㅂ6		뱌
ㅂ7		볘
ㅂ8		븨
ㅂ9		부
ㅂ;		ㅃ
ㅂG		뱨
ㅂb		부
ㅂc		베
ㅂd		비
ㅂe		벼
ㅂf		바
ㅂg		브
ㅂr		배
ㅂt		버
ㅂv		보
ㅃ/		뽀
ㅃ4		뾰
ㅃ5		쀼
ㅃ6		뺘
ㅃ7		뼤
ㅃ8		쁴
ㅃ9		뿌
ㅃG		뺴
ㅃb		뿌
ㅃc		뻬
ㅃd		삐
ㅃe		뼈
ㅃf		빠
ㅃg		쁘
ㅃr		빼
ㅃt		뻐
ㅃv		뽀
ㅅ/		소
ㅅ4		쇼
ㅅ5		슈
ㅅ6		샤
ㅅ7		셰
ㅅ8		싀
ㅅ9		수
ㅅG		섀
ㅅb		수
ㅅc		세
ㅅd		시
ㅅe		셔
ㅅf		사
ㅅg		스
ㅅn		ㅆ
ㅅr		새
ㅅt		서
ㅅv		소
ㅆ/		쏘
ㅆ4		쑈
ㅆ5		쓔
ㅆ6		쌰
ㅆ7		쎼
ㅆ8		씌
ㅆ9		쑤
ㅆG		썌
ㅆb		쑤
ㅆc		쎄
ㅆd		씨
ㅆe		쎠
ㅆf		싸
ㅆg		쓰
ㅆr		쌔
ㅆt		써
ㅆv		쏘
ㅇ/		오
ㅇ4		요
ㅇ5		유
ㅇ6		야
ㅇ7		예
ㅇ8		의
ㅇ9		우
ㅇG		얘
ㅇb		우
ㅇc		에
ㅇd		이
ㅇe		여
ㅇf		아
ㅇg		으
ㅇr		애
ㅇt		어
ㅇv		오
ㅈ/		조
ㅈ4		죠
ㅈ5		쥬
ㅈ6		쟈
ㅈ7		졔
ㅈ8		즤
ㅈ9		주
ㅈG		쟤
ㅈb		주
ㅈc		제
ㅈd		지
ㅈe		져
ㅈf		자
ㅈg		즈
ㅈl		ㅉ
ㅈr		재
ㅈt		저
ㅈv		조
ㅉ/		쪼
ㅉ4		쬬
ㅉ5		쮸
ㅉ6		쨔
ㅉ7		쪠
ㅉ8		쯰
ㅉ9		쭈
ㅉG		쨰
ㅉb		쭈
ㅉc		쩨
ㅉd		찌
ㅉe		쪄
ㅉf		짜
ㅉg		쯔
ㅉr		째
ㅉt		쩌
ㅉv		쪼
ㅊ/		초
ㅊ4		쵸
ㅊ5		츄
ㅊ6		챠
ㅊ7		쳬
ㅊ8		츼
ㅊ9		추
ㅊG		챼
ㅊb		추
ㅊc		체
ㅊd		치
ㅊe		쳐
ㅊf		차
ㅊg		츠
ㅊr		채
ㅊt		처
ㅊv		초
ㅋ/		코
ㅋ4		쿄
ㅋ5		큐
ㅋ6		캬
ㅋ7		켸
ㅋ8		킈
ㅋ9		쿠
ㅋG		컈
ㅋb		쿠
ㅋc		케
ㅋd		키
ㅋe		켜
ㅋf		카
ㅋg		크
ㅋr		캐
ㅋt		커
ㅋv		코
ㅌ/		토
ㅌ4		툐
ㅌ5		튜
ㅌ6		탸
ㅌ7		톄
ㅌ8		틔
ㅌ9		투
ㅌG		턔
ㅌb		투
ㅌc		테
ㅌd		티
ㅌe		텨
ㅌf		타
ㅌg		트
ㅌr		태
ㅌt		터
ㅌv		토
ㅍ/		포
ㅍ4		표
ㅍ5		퓨
ㅍ6		퍄
ㅍ7		폐
ㅍ8		픠
ㅍ9		푸
ㅍG		퍠
ㅍb		푸
ㅍc		페
ㅍd		피
ㅍe		펴
ㅍf		파
ㅍg		프
ㅍr		패
ㅍt		퍼
ㅍv		포
ㅎ/		호
ㅎ4		효
ㅎ5		휴
ㅎ6		햐
ㅎ7		혜
ㅎ8		희
ㅎ9		후
ㅎG		햬
ㅎb		후
ㅎc		헤
ㅎd		히
ㅎe		혀
ㅎf		하
ㅎg		흐
ㅎr		해
ㅎt		허
ㅎv		호
가!		갂
가"		갉
가#		갖
가$		갎
가%		갍
가1		갛
가2		갔
가3		갑
가A		갇
가C		갘
가D		갋
가E		갅
가F		갊
가Q		갚
가R		갏
가S		갆
가T		갌
가V		갃
가W		같
가X		값
가Z		갗
가a		강
가q		갓
가s		간
가w		갈
가x		각
가z		감
개!		갞
개"		갥
개#		갲
개$		갪
개%		갩
개1		갷
개2		갰
개3		갭
개A		갣
개C		갴
개D		갧
개E		갡
개F		갦
개Q		갶
개R		갫
개S		갢
개T		갨
개V		갟
개W		갵
개X		갮
개Z		갳
개a		갱
개q		갯
개s		갠
개w		갤
개x		객
개z		갬
갸!		갺
갸"		걁
갸#		걎
갸$		걆
갸%		걅
갸1		걓
갸2		걌
갸3		걉
갸A		갿
갸C		걐
갸D		걃
갸E		갽
갸F		걂
갸Q		걒
갸R		걇
갸S		갾
갸T		걄
갸V		갻
갸W		걑
갸X		걊
갸Z		걏
갸a		걍
갸q		걋
갸s		갼
갸w		걀
갸x		갹
갸z		걈
걔!		걖
걔"		걝
걔#		걪
걔$		걢
걔%		걡
걔1		걯
걔2		걨
걔3		걥
걔A		걛
걔C		걬
걔D		걟
걔E		걙
걔F		걞
걔Q		걮
걔R		걣
걔S		걚
걔T		걠
걔V		걗
걔W		걭
걔X		걦
걔Z		걫
걔a		걩
걔q		걧
걔s		걘
걔w		걜
걔x		걕
걔z		걤
거!		걲
거"		걹
거#		겆
거$		걾
거%		걽
거1		겋
거2		겄
거3		겁
거A		걷
거C		겈
거D		걻
거E		걵
거F		걺
거Q		겊
거R		걿
거S		걶
거T		걼
거V		걳
거W		겉
거X		겂
거Z		겇
거a		겅
거q		것
거s		건
거w		걸
거x		걱
거z		검
게!		겎
게"		겕
게#		겢
게$		겚
게%		겙
게1		겧
게2		겠
게3		겝
게A		겓
게C		겤
게D		겗
게E		겑
게F		겖
게Q		겦
게R		겛
게S		겒
게T		겘
게V		겏
게W		겥
게X		겞
게Z		겣
게a		겡
게q		겟
게s		겐
게w		겔
게x		겍
게z		겜
겨!		겪
겨"		겱
겨#		겾
겨$		겶
겨%		겵
겨1		곃
겨2		겼
겨3		겹
겨A		겯
겨C		곀
겨D		겳
겨E		겭
겨F		겲
겨Q		곂
겨R		겷
겨S		겮
겨T		겴
겨V		겫
겨W		곁
겨X		겺
겨Z		겿
겨a		경
겨q		겻
겨s		견
겨w		결
겨x		격
겨z		겸
계!		곆
계"		곍
계#		곚
계$		곒
계%		곑
계1		곟
계2		곘
계3		곕
계A		곋
계C		곜
계D		곏
계E		곉
계F		곎
계Q		곞
계R		곓
계S		곊
계T		곐
계V		곇
계W		곝
계X		곖
계Z		곛
계a		곙
계q		곗
계s		곈
계w		곌
계x		곅
계z		곔
고!		곢
고"		곩
고#		곶
고$		곮
고%		곭
고1		곻
고2		곴
고3		곱
고A		곧
고C		곸
고D		곫
고E		곥
고F		곪
고Q		곺
고R		곯
고S		곦
고T		곬
고V		곣
고W		곹
고X		곲
고Z		곷
고a		공
고d		괴
고f		과
고q		곳
고r		괘
고s		곤
고w		골
고x		곡
고z		곰
과!		곾
과"		괅
과#		괒
과$		괊
과%		괉
과1		괗
과2		괐
과3		괍
과A		괃
과C		괔
과D		괇
과E		괁
과F		괆
과Q		괖
과R		괋
과S		괂
과T		괈
과V		곿
과W		괕
과X		괎
과Z		괓
과a		광
과q		괏
과s		관
과w		괄
과x		곽
과z		괌
괘!		괚
괘"		괡
괘#		괮
괘$		괦
괘%		괥
괘1		괳
괘2		괬
괘3		괩
괘A		괟
괘C		괰
괘D		괣
괘E		괝
괘F		괢
괘Q		괲
괘R		괧
괘S		괞
괘T		괤
괘V		괛
괘W		괱
괘X		괪
괘Z		괯
괘a		괭
괘q		괫
괘s		괜
괘w		괠
괘x		괙
괘z		괨
괴!		괶
괴"		괽
괴#		굊
괴$		굂
괴%		굁
괴1		굏
괴2		굈
괴3		굅
괴A		괻
괴C		굌
괴D		괿
괴E		괹
괴F		괾
괴Q		굎
괴R		굃
괴S		괺
괴T		굀
괴V		괷
괴W		굍
괴X		굆
괴Z		굋
괴a		굉
괴q		굇
괴s		괸
괴w		괼
괴x		괵
괴z		굄
교!		굒
교"		굙
교#		굦
교$		굞
교%		굝
교1		굫
교2		굤
교3		굡
교A		굗
교C		굨
교D		굛
교E		굕
교F		굚
교Q		굪
교R		굟
교S		굖
교T		굜
교V		굓
교W		굩
교X		굢
교Z		굧
교a		굥
교q		굣
교s		굔
교w		굘
교x		굑
교z		굠
구!		굮
구"		굵
구#		궂
구$		굺
구%		굹
구1		궇
구2		궀
구3		굽
구A		굳
구C		궄
구D		굷
구E		굱
구F		굶
구Q		궆
구R		굻
구S		굲
구T		굸
구V		굯
구W		궅
구X		굾
구Z		궃
구a		궁
구c		궤
구d		귀
구q		굿
구s		군
구t		궈
구w		굴
구x		국
구z		굼
궈!		궊
궈"		궑
궈#		궞
궈$		궖
궈%		궕
궈1		궣
궈2		궜
궈3		궙
궈A		궏
궈C		궠
궈D		궓
궈E		궍
궈F		궒
궈Q		궢
궈R		궗
궈S		궎
궈T		궔
궈V		궋
궈W		궡
궈X		궚
궈Z		궟
궈a		궝
궈q		궛
궈s		권
궈w		궐
궈x		궉
궈z		궘
궤!		궦
궤"		궭
궤#		궺
궤$		궲
궤%		궱
궤1		궿
궤2		궸
궤3		궵
궤A		궫
궤C		궼
궤D		궯
궤E		궩
궤F		궮
궤Q		궾
궤R		궳
궤S		궪
궤T		궰
궤V		궧
궤W		궽
궤X		궶
궤Z		궻
궤a		궹
궤q		궷
궤s		궨
궤w		궬
궤x		궥
궤z		궴
귀!		귂
귀"		귉
귀#		귖
귀$		귎
귀%		귍
귀1		귛
귀2		귔
귀3		귑
귀A		귇
귀C		귘
귀D		귋
귀E		귅
귀F		귊
귀Q		귚
귀R		귏
귀S		귆
귀T		귌
귀V		귃
귀W		귙
귀X		귒
귀Z		귗
귀a		귕
귀q		귓
귀s		귄
귀w		귈
귀x		귁
귀z		귐
규!		귞
규"		귥
규#		귲
규$		귪
규%		귩
규1		귷
규2		귰
규3		귭
규A		귣
규C		귴
규D		귧
규E		귡
규F		귦
규Q		귶
규R		귫
규S		귢
규T		귨
규V		귟
규W		귵
규X		귮
규Z		귳
규a		귱
규q		귯
규s		균
규w		귤
규x		귝
규z		귬
그!		귺
그"		긁
그#		긎
그$		긆
그%		긅
그1		긓
그2		긌
그3		급
그A		귿
그C		긐
그D		긃
그E		귽
그F		긂
그Q		긒
그R		긇
그S		귾
그T		긄
그V		귻
그W		긑
그X		긊
그Z		긏
그a		긍
그q		긋
그s		근
그w		글
그x		극
그z		금
긔!		긖
긔"		긝
긔#		긪
긔$		긢
긔%		긡
긔1		긯
긔2		긨
긔3		긥
긔A		긛
긔C		긬
긔D		긟
긔E		긙
긔F		긞
긔Q		긮
긔R		긣
긔S		긚
긔T		긠
긔V		긗
긔W		긭
긔X		긦
긔Z		긫
긔a		긩
긔q		긧
긔s		긘
긔w		긜
긔x		긕
긔z		긤
기!		긲
기"		긹
기#		깆
기$		긾
기%		긽
기1		깋
기2		깄
기3		깁
기A		긷
기C		깈
기D		긻
기E		긵
기F		긺
기Q		깊
기R		긿
기S		긶
기T		긼
기V		긳
기W		깉
기X		깂
기Z		깇
기a		깅
기q		깃
기s		긴
기w		길
기x		긱
기z		김
까!		깎
까"		깕
까#		깢
까$		깚
까%		깙
까1		깧
까2		깠
까3		깝
까A		깓
까C		깤
까D		깗
까E		깑
까F		깖
까Q		깦
까R		깛
까S		깒
까T		깘
까V		깏
까W		깥
까X		깞
까Z		깣
까a		깡
까q		깟
까s		깐
까w		깔
까x		깍
까z		깜
깨!		깪
깨"		깱
깨#		깾
깨$		깶
깨%		깵
깨1		꺃
깨2		깼
깨3		깹
깨A		깯
깨C		꺀
깨D		깳
깨E		깭
깨F		깲
깨Q		꺂
깨R		깷
깨S		깮
깨T		깴
깨V		깫
깨W		꺁
깨X		깺
깨Z		깿
깨a		깽
깨q		깻
깨s		깬
깨w		깰
깨x		깩
깨z		깸
꺄!		꺆
꺄"		꺍
꺄#		꺚
꺄$		꺒
꺄%		꺑
꺄1		꺟
꺄2		꺘
꺄3		꺕
꺄A		꺋
꺄C		꺜
꺄D		꺏
꺄E		꺉
꺄F		꺎
꺄Q		꺞
꺄R		꺓
꺄S		꺊
꺄T		꺐
꺄V		꺇
꺄W		꺝
꺄X		꺖
꺄Z		꺛
꺄a		꺙
꺄q		꺗
꺄s		꺈
꺄w		꺌
꺄x		꺅
꺄z		꺔
꺠!		꺢
꺠"		꺩
꺠#		꺶
꺠$		꺮
꺠%		꺭
꺠1		꺻
꺠2		꺴
꺠3		꺱
꺠A		꺧
꺠C		꺸
꺠D		꺫
꺠E		꺥
꺠F		꺪
꺠Q		꺺
꺠R		꺯
꺠S		꺦
꺠T		꺬
꺠V		꺣
꺠W		꺹
꺠X		꺲
꺠Z		꺷
꺠a		꺵
꺠q		꺳
꺠s		꺤
꺠w		꺨
꺠x		꺡
꺠z		꺰
꺼!		꺾
꺼"		껅
꺼#		껒
꺼$		껊
꺼%		껉
꺼1		껗
꺼2		껐
꺼3		껍
꺼A		껃
꺼C		껔
꺼D		껇
꺼E		껁
꺼F		껆
꺼Q		껖
꺼R		껋
꺼S		껂
꺼T		껈
꺼V		꺿
꺼W		껕
꺼X		껎
꺼Z		껓
꺼a		껑
꺼q		껏
꺼s		껀
꺼w		껄
꺼x		꺽
꺼z		껌
께!		껚
께"		껡
께#		껮
께$		껦
께%		껥
께1		껳
께2		껬
께3		껩
께A		껟
께C		껰
께D		껣
께E		껝
께F		껢
께Q		껲
께R		껧
께S		껞
께T		껤
께V		껛
께W		껱
께X		껪
께Z		껯
께a		껭
께q		껫
께s		껜
께w		껠
께x		껙
께z		껨
껴!		껶
껴"		껽
껴#		꼊
껴$		꼂
껴%		꼁
껴1		꼏
껴2		꼈
껴3		꼅
껴A		껻
껴C		꼌
껴D		껿
껴E		껹
껴F		껾
껴Q		꼎
껴R		꼃
껴S		껺
껴T		꼀
껴V		껷
껴W		꼍
껴X		꼆
껴Z		꼋
껴a		꼉
껴q		꼇
껴s		껸
껴w		껼
껴x		껵
껴z		꼄
꼐!		꼒
꼐"		꼙
꼐#		꼦
꼐$		꼞
꼐%		꼝
꼐1		꼫
꼐2		꼤
꼐3		꼡
꼐A		꼗
꼐C		꼨
꼐D		꼛
꼐E		꼕
꼐F		꼚
꼐Q		꼪
꼐R		꼟
꼐S		꼖
꼐T		꼜
꼐V		꼓
꼐W		꼩
꼐X		꼢
꼐Z		꼧
꼐a		꼥
꼐q		꼣
꼐s		꼔
꼐w		꼘
꼐x		꼑
꼐z		꼠
꼬!		꼮
꼬"		꼵
꼬#		꽂
꼬$		꼺
꼬%		꼹
꼬1		꽇
꼬2		꽀
꼬3		꼽
꼬A		꼳
꼬C		꽄
꼬D		꼷
꼬E		꼱
꼬F		꼶
꼬Q		꽆
꼬R		꼻
꼬S		꼲
꼬T		꼸
꼬V		꼯
꼬W		꽅
꼬X		꼾
꼬Z		꽃
꼬a		꽁
꼬d		꾀
꼬f		꽈
꼬q		꼿
꼬r		꽤
꼬s		꼰
꼬w		꼴
꼬x		꼭
꼬z		꼼
꽈!		꽊
꽈"		꽑
꽈#		꽞
꽈$		꽖
꽈%		꽕
꽈1		꽣
꽈2		꽜
꽈3		꽙
꽈A		꽏
꽈C		꽠
꽈D		꽓
꽈E		꽍
꽈F		꽒
꽈Q		꽢
꽈R		꽗
꽈S		꽎
꽈T		꽔
꽈V		꽋
꽈W		꽡
꽈X		꽚
꽈Z		꽟
꽈a		꽝
꽈q		꽛
꽈s		꽌
꽈w		꽐
꽈x		꽉
꽈z		꽘
꽤!		꽦
꽤"		꽭
꽤#		꽺
꽤$		꽲
꽤%		꽱
꽤1		꽿
꽤2		꽸
꽤3		꽵
꽤A		꽫
꽤C		꽼
꽤D		꽯
꽤E		꽩
꽤F		꽮
꽤Q		꽾
꽤R		꽳
꽤S		꽪
꽤T		꽰
꽤V		꽧
꽤W		꽽
꽤X		꽶
꽤Z		꽻
꽤a		꽹
꽤q		꽷
꽤s		꽨
꽤w		꽬
꽤x		꽥
꽤z		꽴
꾀!		꾂
꾀"		꾉
꾀#		꾖
꾀$		꾎
꾀%		꾍
꾀1		꾛
꾀2		꾔
꾀3		꾑
꾀A		꾇
꾀C		꾘
꾀D		꾋
꾀E		꾅
꾀F		꾊
꾀Q		꾚
꾀R		꾏
꾀S		꾆
꾀T		꾌
꾀V		꾃
꾀W		꾙
꾀X		꾒
꾀Z		꾗
꾀a		꾕
꾀q		꾓
꾀s		꾄
꾀w		꾈
꾀x		꾁
꾀z		꾐
꾜!		꾞
꾜"		꾥
꾜#		꾲
꾜$		꾪
꾜%		꾩
꾜1		꾷
꾜2		꾰
꾜3		꾭
꾜A		꾣
꾜C		꾴
꾜D		꾧
꾜E		꾡
꾜F		꾦
꾜Q		꾶
꾜R		꾫
꾜S		꾢
꾜T		꾨
꾜V		꾟
꾜W		꾵
꾜X		꾮
꾜Z		꾳
꾜a		꾱
꾜q		꾯
꾜s		꾠
꾜w		꾤
꾜x		꾝
꾜z		꾬
꾸!		꾺
꾸"		꿁
꾸#		꿎
꾸$		꿆
꾸%		꿅
꾸1		꿓
꾸2		꿌
꾸3		꿉
꾸A		꾿
꾸C		꿐
꾸D		꿃
꾸E		꾽
꾸F		꿂
꾸Q		꿒
꾸R		꿇
꾸S		꾾
꾸T		꿄
꾸V		꾻
꾸W		꿑
꾸X		꿊
꾸Z		꿏
꾸a		꿍
꾸c		꿰
꾸d		뀌
꾸q		꿋
꾸s		꾼
꾸t		꿔
꾸w		꿀
꾸x		꾹
꾸z		꿈
꿔!		꿖
꿔"		꿝
꿔#		꿪
꿔$		꿢
꿔%		꿡
꿔1		꿯
꿔2		꿨
꿔3		꿥
꿔A		꿛
꿔C		꿬
꿔D		꿟
꿔E		꿙
꿔F		꿞
꿔Q		꿮
꿔R		꿣
꿔S		꿚
꿔T		꿠
꿔V		꿗
꿔W		꿭
꿔X		꿦
꿔Z		꿫
꿔a		꿩
꿔q		꿧
꿔s		꿘
꿔w		꿜
꿔x		꿕
꿔z		꿤
꿰!		꿲
꿰"		꿹
꿰#		뀆
꿰$		꿾
꿰%		꿽
꿰1		뀋
꿰2		뀄
꿰3		뀁
꿰A		꿷
꿰C		뀈
꿰D		꿻
꿰E		꿵
꿰F		꿺
꿰Q		뀊
꿰R		꿿
꿰S		꿶
꿰T		꿼
꿰V		꿳
꿰W		뀉
꿰X		뀂
꿰Z		뀇
꿰a		뀅
꿰q		뀃
꿰s		꿴
꿰w		꿸
꿰x		꿱
꿰z		뀀
뀌!		뀎
뀌"		뀕
뀌#		뀢
뀌$		뀚
뀌%		뀙
뀌1		뀧
뀌2		뀠
뀌3		뀝
뀌A		뀓
뀌C		뀤
뀌D		뀗
뀌E		뀑
뀌F		뀖
뀌Q		뀦
뀌R		뀛
뀌S		뀒
뀌T		뀘
뀌V		뀏
뀌W		뀥
뀌X		뀞
뀌Z		뀣
뀌a		뀡
뀌q		뀟
뀌s		뀐
뀌w		뀔
뀌x		뀍
뀌z		뀜
뀨!		뀪
뀨"		뀱
뀨#		뀾
뀨$		뀶
뀨%		뀵
뀨1		끃
뀨2		뀼
뀨3		뀹
뀨A		뀯
뀨C		끀
뀨D		뀳
뀨E		뀭
뀨F		뀲
뀨Q		끂
뀨R		뀷
뀨S		뀮
뀨T		뀴
뀨V		뀫
뀨W		끁
뀨X		뀺
뀨Z		뀿
뀨a		뀽
뀨q		뀻
뀨s		뀬
뀨w		뀰
뀨x		뀩
뀨z		뀸
끄!		끆
끄"		끍
끄#		끚
끄$		끒
끄%		끑
끄1		끟
끄2		끘
끄3		끕
끄A		끋
끄C		끜
끄D		끏
끄E		끉
끄F		끎
끄Q		끞
끄R		끓
끄S		끊
끄T		끐
끄V		끇
끄W		끝
끄X		끖
끄Z		끛
끄a		끙
끄q		끗
끄s		끈
끄w		끌
끄x		끅
끄z		끔
끠!		끢
끠"		끩
끠#		끶
끠$		끮
끠%		끭
끠1		끻
끠2		끴
끠3		끱
끠A		끧
끠C		끸
끠D		끫
끠E		끥
끠F		끪
끠Q		끺
끠R		끯
끠S		끦
끠T		끬
끠V		끣
끠W		끹
끠X		끲
끠Z		끷
끠a		끵
끠q		끳
끠s		끤
끠w		끨
끠x		끡
끠z		끰
끼!		끾
끼"		낅
끼#		낒
끼$		낊
끼%		낉
끼1		낗
끼2		낐
끼3		낍
끼A		낃
끼C		낔
끼D		낇
끼E		낁
끼F		낆
끼Q		낖
끼R		낋
끼S		낂
끼T		낈
끼V		끿
끼W		낕
끼X		낎
끼Z		낓
끼a		낑
끼q		낏
끼s		낀
끼w		낄
끼x		끽
끼z		낌
나!		낚
나"		낡
나#		낮
나$		낦
나%		낥
나1		낳
나2		났
나3		납
나A		낟
나C		낰
나D		낣
나E		낝
나F		낢
나Q		낲
나R		낧
나S		낞
나T		낤
나V		낛
나W		낱
나X		낪
나Z		낯
나a		낭
나q		낫
나s		난
나w		날
나x		낙
나z		남
내!		낶
내"		낽
내#		냊
내$		냂
내%		냁
내1		냏
내2		냈
내3		냅
내A		낻
내C		냌
내D		낿
내E		낹
내F		낾
내Q		냎
내R		냃
내S		낺
내T		냀
내V		낷
내W		냍
내X		냆
내Z		냋
내a		냉
내q		냇
내s		낸
내w		낼
내x		낵
내z		냄
냐!		냒
냐"		냙
냐#		냦
냐$		냞
냐%		냝
냐1		냫
냐2		냤
냐3		냡
냐A		냗
냐C		냨
냐D		냛
냐E		냕
냐F		냚
냐Q		냪
냐R		냟
냐S		냖
냐T		냜
냐V		냓
냐W		냩
냐X		냢
냐Z		냧
냐a		냥
냐q		냣
냐s		냔
냐w		냘
냐x		냑
냐z		냠
냬!		냮
냬"		냵
냬#		넂
냬$		냺
냬%		냹
냬1		넇
냬2		넀
냬3		냽
냬A		냳
냬C		넄
냬D		냷
냬E		냱
냬F		냶
냬Q		넆
냬R		냻
냬S		냲
냬T		냸
냬V		냯
냬W		넅
냬X		냾
냬Z		넃
냬a		넁
냬q		냿
냬s		냰
냬w		냴
냬x		냭
냬z		냼
너!		넊
너"		넑
너#		넞
너$		넖
너%		넕
너1		넣
너2		넜
너3		넙
너A		넏
너C		넠
너D		넓
너E		넍
너F		넒
너Q		넢
너R		넗
너S		넎
너T		넔
너V		넋
너W		넡
너X		넚
너Z		넟
너a		넝
너q		넛
너s		넌
너w		널
너x		넉
너z		넘
네!		넦
네"		넭
네#		넺
네$		넲
네%		넱
네1		넿
네2		넸
네3		넵
네A		넫
네C		넼
네D		넯
네E		넩
네F		넮
네Q		넾
네R		넳
네S		넪
네T		넰
네V		넧
네W		넽
네X		넶
네Z		넻
네a		넹
네q		넷
네s		넨
네w		넬
네x		넥
네z		넴
녀!		녂
녀"		녉
녀#		녖
녀$		녎
녀%		녍
녀1		녛
녀2		녔
녀3		녑
녀A		녇
녀C		녘
녀D		녋
녀E		녅
녀F		녊
녀Q		녚
녀R		녏
녀S		녆
녀T		녌
녀V		녃
녀W		녙
녀X		녒
녀Z		녗
녀a		녕
녀q		녓
녀s		년
녀w		녈
녀x		녁
녀z		념
녜!		녞
녜"		녥
녜#		녲
녜$		녪
녜%		녩
녜1		녷
녜2		녰
녜3		녭
녜A		녣
녜C		녴
녜D		녧
녜E		녡
녜F		녦
녜Q		녶
녜R		녫
녜S		녢
녜T		녨
녜V		녟
녜W		녵
녜X		녮
녜Z		녳
녜a		녱
녜q		녯
녜s		녠
녜w		녤
녜x		녝
녜z		녬
노!		녺
노"		놁
노#		놎
노$		놆
노%		놅
노1		놓
노2		놌
노3		놉
노A		녿
노C		놐
노D		놃
노E		녽
노F		놂
노Q		높
노R		놇
노S		녾
노T		놄
노V		녻
노W		놑
노X		놊
노Z		놏
노a		농
노d		뇌
노f		놔
노q		놋
노r		놰
노s		논
노w		놀
노x		녹
노z		놈
놔!		놖
놔"		놝
놔#		놪
놔$		놢
놔%		놡
놔1		놯
놔2		놨
놔3		놥
놔A		놛
놔C		놬
놔D		놟
놔E		놙
놔F		놞
놔Q		놮
놔R		놣
놔S		놚
놔T		놠
놔V		놗
놔W		놭
놔X		놦
놔Z		놫
놔a		놩
놔q		놧
놔s		놘
놔w		놜
놔x		놕
놔z		놤
놰!		놲
놰"		놹
놰#		뇆
놰$		놾
놰%		놽
놰1		뇋
놰2		뇄
놰3		뇁
놰A		놷
놰C		뇈
놰D		놻
놰E		놵
놰F		놺
놰Q		뇊
놰R		놿
놰S		놶
놰T		놼
놰V		놳
놰W		뇉
놰X		뇂
놰Z		뇇
놰a		뇅
놰q		뇃
놰s		놴
놰w		놸
놰x		놱
놰z		뇀
뇌!		뇎
뇌"		뇕
뇌#		뇢
뇌$		뇚
뇌%		뇙
뇌1		뇧
뇌2		뇠
뇌3		뇝
뇌A		뇓
뇌C		뇤
뇌D		뇗
뇌E		뇑
뇌F		뇖
뇌Q		뇦
뇌R		뇛
뇌S		뇒
뇌T		뇘
뇌V		뇏
뇌W		뇥
뇌X		뇞
뇌Z		뇣
뇌a		뇡
뇌q		뇟
뇌s		뇐
뇌w		뇔
뇌x		뇍
뇌z		뇜
뇨!		뇪
뇨"		뇱
뇨#		뇾
뇨$		뇶
뇨%		뇵
뇨1		눃
뇨2		뇼
뇨3		뇹
뇨A		뇯
뇨C		눀
뇨D		뇳
뇨E		뇭
뇨F		뇲
뇨Q		눂
뇨R		뇷
뇨S		뇮
뇨T		뇴
뇨V		뇫
뇨W		눁
뇨X		뇺
뇨Z		뇿
뇨a		뇽
뇨q		뇻
뇨s		뇬
뇨w		뇰
뇨x		뇩
뇨z		뇸
누!		눆
누"		눍
누#		눚
누$		눒
누%		눑
누1		눟
누2		눘
누3		눕
누A		눋
누C		눜
누D		눏
누E		눉
누F		눎
누Q		눞
누R		눓
누S		눊
누T		눐
누V		눇
누W		눝
누X		눖
누Z		눛
누a		눙
누c		눼
누d		뉘
누q		눗
누s		눈
누t		눠
누w		눌
누x		눅
누z		눔
눠!		눢
눠"		눩
눠#		눶
눠$		눮
눠%		눭
눠1		눻
눠2		눴
눠3		눱
눠A		눧
눠C		눸
눠D		눫
눠E		눥
눠F		눪
눠Q		눺
눠R		눯
눠S		눦
눠T		눬
눠V		눣
눠W		눹
눠X		눲
눠Z		눷
눠a		눵
눠q		눳
눠s		눤
눠w		눨
눠x		눡
눠z		눰
눼!		눾
눼"		뉅
눼#		뉒
눼$		뉊
눼%		뉉
눼1		뉗
눼2		뉐
눼3		뉍
눼A		뉃
눼C		뉔
눼D		뉇
눼E		뉁
눼F		뉆
눼Q		뉖
눼R		뉋
눼S		뉂
눼T		뉈
눼V		눿
눼W		뉕
눼X		뉎
눼Z		뉓
눼a		뉑
눼q		뉏
눼s		뉀
눼w		뉄
눼x		눽
눼z		뉌
뉘!		뉚
뉘"		뉡
뉘#		뉮
뉘$		뉦
뉘%		뉥
뉘1		뉳
뉘2		뉬
뉘3		뉩
뉘A		뉟
뉘C		뉰
뉘D		뉣
뉘E		뉝
뉘F		뉢
뉘Q		뉲
뉘R		뉧
뉘S		뉞
뉘T		뉤
뉘V		뉛
뉘W		뉱
뉘X		뉪
뉘Z		뉯
뉘a		뉭
뉘q		뉫
뉘s		뉜
뉘w		뉠
뉘x		뉙
뉘z		뉨
뉴!		뉶
뉴"		뉽
뉴#		늊
뉴$		늂
뉴%		늁
뉴1		늏
뉴2		늈
뉴3		늅
뉴A		뉻
뉴C		늌
뉴D		뉿
뉴E		뉹
뉴F		뉾
뉴Q		늎
뉴R		늃
뉴S		뉺
뉴T		늀
뉴V		뉷
뉴W		늍
뉴X		늆
뉴Z		늋
뉴a		늉
뉴q		늇
뉴s		뉸
뉴w		뉼
뉴x		뉵
뉴z		늄
느!		늒
느"		늙
느#		늦
느$		늞
느%		늝
느1		늫
느2		늤
느3		늡
느A		늗
느C		늨
느D		늛
느E		늕
느F		늚
느Q		늪
느R		늟
느S		늖
느T		늜
느V		늓
느W		늩
느X		늢
느Z		늧
느a		능
느q		늣
느s		는
느w		늘
느x		늑
느z		늠
늬!		늮
늬"		늵
늬#		닂
늬$		늺
늬%		늹
늬1		닇
늬2		닀
늬3		늽
늬A		늳
늬C		닄
늬D		늷
늬E		늱
늬F		늶
늬Q		닆
늬R		늻
늬S		늲
늬T		늸
늬V		늯
늬W		닅
늬X		늾
늬Z		닃
늬a		닁
늬q		늿
늬s		늰
늬w		늴
늬x		늭
늬z		늼
니!		닊
니"		닑
니#		닞
니$		닖
니%		닕
니1		닣
니2		닜
니3		닙
니A		닏
니C		닠
니D		닓
니E		닍
니F		닒
니Q		닢
니R		닗
니S		닎
니T		닔
니V		닋
니W		닡
니X		닚
니Z		닟
니a		닝
니q		닛
니s		닌
니w		닐
니x		닉
니z		님
다!		닦
다"		닭
다#		닺
다$		닲
다%		닱
다1		닿
다2		닸
다3		답
다A		닫
다C		닼
다D		닯
다E		닩
다F		닮
다Q		닾
다R		닳
다S		닪
다T		닰
다V		닧
다W		닽
다X		닶
다Z		닻
다a		당
다q		닷
다s		단
다w		달
다x		닥
다z		담
대!		댂
대"		댉
대#		댖
대$		댎
대%		댍
대1		댛
대2		댔
대3		댑
대A		댇
대C		댘
대D		댋
대E		댅
대F		댊
대Q		댚
대R		댏
대S		댆
대T		댌
대V		댃
대W		댙
대X		댒
대Z		댗
대a		댕
대q		댓
대s		댄
대w		댈
대x		댁
대z		댐
댜!		댞
댜"		댥
댜#		댲
댜$		댪
댜%		댩
댜1		댷
댜2		댰
댜3		댭
댜A		댣
댜C		댴
댜D		댧
댜E		댡
댜F		댦
댜Q		댶
댜R		댫
댜S		댢
댜T		댨
댜V		댟
댜W		댵
댜X		댮
댜Z		댳
댜a		댱
댜q		댯
댜s		댠
댜w		댤
댜x		댝
댜z		댬
댸!		댺
댸"		덁
댸#		덎
댸$		덆
댸%		덅
댸1		덓
댸2		덌
댸3		덉
댸A		댿
댸C		덐
댸D		덃
댸E		댽
댸F		덂
댸Q		덒
댸R		덇
댸S		댾
댸T		덄
댸V		댻
댸W		덑
댸X		덊
댸Z		덏
댸a		덍
댸q		덋
댸s		댼
댸w		덀
댸x		댹
댸z		덈
더!		덖
더"		덝
더#		덪
더$		덢
더%		덡
더1		덯
더2		덨
더3		덥
더A		덛
더C		덬
더D		덟
더E		덙
더F		덞
더Q		덮
더R		덣
더S		덚
더T		덠
더V		덗
더W		덭
더X		덦
더Z		덫
더a		덩
더q		덧
더s		던
더w		덜
더x		덕
더z		덤
데!		덲
데"		덹
데#		뎆
데$		덾
데%		덽
데1		뎋
데2		뎄
데3		뎁
데A		덷
데C		뎈
데D		덻
데E		덵
데F		덺
데Q		뎊
데R		덿
데S		덶
데T		덼
데V		덳
데W		뎉
데X		뎂
데Z		뎇
데a		뎅
데q		뎃
데s		덴
데w		델
데x		덱
데z		뎀
뎌!		뎎
뎌"		뎕
뎌#		뎢
뎌$		뎚
뎌%		뎙
뎌1		뎧
뎌2		뎠
뎌3		뎝
뎌A		뎓
뎌C		뎤
뎌D		뎗
뎌E		뎑
뎌F		뎖
뎌Q		뎦
뎌R		뎛
뎌S		뎒
뎌T		뎘
뎌V		뎏
뎌W		뎥
뎌X		뎞
뎌Z		뎣
뎌a		뎡
뎌q		뎟
뎌s		뎐
뎌w		뎔
뎌x		뎍
뎌z		뎜
뎨!		뎪
뎨"		뎱
뎨#		뎾
뎨$		뎶
뎨%		뎵
뎨1		돃
뎨2		뎼
뎨3		뎹
뎨A		뎯
뎨C		돀
뎨D		뎳
뎨E		뎭
뎨F		뎲
뎨Q		돂
뎨R		뎷
뎨S		뎮
뎨T		뎴
뎨V		뎫
뎨W		돁
뎨X		뎺
뎨Z		뎿
뎨a		뎽
뎨q		뎻
뎨s		뎬
뎨w		뎰
뎨x		뎩
뎨z		뎸
도!		돆
도"		돍
도#		돚
도$		돒
도%		돑
도1		돟
도2		돘
도3		돕
도A		돋
도C		돜
도D		돏
도E		돉
도F		돎
도Q		돞
도R		돓
도S		돊
도T		돐
도V		돇
도W		돝
도X		돖
도Z		돛
도a		동
도d		되
도f		돠
도q		돗
도r		돼
도s		돈
도w		돌
도x		독
도z		돔
돠!		돢
돠"		돩
돠#		돶
돠$		돮
돠%		돭
돠1		돻
돠2		돴
돠3		돱
돠A		돧
돠C		돸
돠D		돫
돠E		돥
돠F		돪
돠Q		돺
돠R		돯
돠S		돦
돠T		돬
돠V		돣
돠W		돹
돠X		돲
돠Z		돷
돠a		돵
돠q		돳
돠s		돤
돠w		돨
돠x		돡
돠z		돰
돼!		돾
돼"		됅
돼#		됒
돼$		됊
돼%		됉
돼1		됗
돼2		됐
돼3		됍
돼A		됃
돼C		됔
돼D		됇
돼E		됁
돼F		됆
돼Q		됖
돼R		됋
돼S		됂
돼T		됈
돼V		돿
돼W		됕
돼X		됎
돼Z		됓
돼a		됑
돼q		됏
돼s		됀
돼w		됄
돼x		돽
돼z		됌
되!		됚
되"		됡
되#		됮
되$		됦
되%		됥
되1		됳
되2		됬
되3		됩
되A		됟
되C		됰
되D		됣
되E		됝
되F		됢
되Q		됲
되R		됧
되S		됞
되T		됤
되V		됛
되W		됱
되X		됪
되Z		됯
되a		됭
되q		됫
되s		된
되w		될
되x		됙
되z		됨
됴!		됶
됴"		됽
됴#		둊
됴$		둂
됴%		둁
됴1		둏
됴2		둈
됴3		둅
됴A		됻
됴C		둌
됴D		됿
됴E		됹
됴F		됾
됴Q		둎
됴R		둃
됴S		됺
됴T		둀
됴V		됷
됴W		둍
됴X		둆
됴Z		둋
됴a		둉
됴q		둇
됴s		됸
됴w		됼
됴x		됵
됴z		둄
두!		둒
두"		둙
두#		둦
두$		둞
두%		둝
두1		둫
두2		둤
두3		둡
두A		둗
두C		둨
두D		둛
두E		둕
두F		둚
두Q		둪
두R		둟
두S		둖
두T		둜
두V		둓
두W		둩
두X		둢
두Z		둧
두a		둥
두c		뒈
두d		뒤
두q		둣
두s		둔
두t		둬
두w		둘
두x		둑
두z		둠
둬!		둮
둬"		둵
둬#		뒂
둬$		둺
둬%		둹
둬1		뒇
둬2		뒀
둬3		둽
둬A		둳
둬C		뒄
둬D		둷
둬E		둱
둬F		둶
둬Q		뒆
둬R		둻
둬S		둲
둬T		둸
둬V		둯
둬W		뒅
둬X		둾
둬Z		뒃
둬a		뒁
둬q		둿
둬s		둰
둬w		둴
둬x		둭
둬z		둼
뒈!		뒊
뒈"		뒑
뒈#		뒞
뒈$		뒖
뒈%		뒕
뒈1		뒣
뒈2		뒜
뒈3		뒙
뒈A		뒏
뒈C		뒠
뒈D		뒓
뒈E		뒍
뒈F		뒒
뒈Q		뒢
뒈R		뒗
뒈S		뒎
뒈T		뒔
뒈V		뒋
뒈W		뒡
뒈X		뒚
뒈Z		뒟
뒈a		뒝
뒈q		뒛
뒈s		뒌
뒈w		뒐
뒈x		뒉
뒈z		뒘
뒤!		뒦
뒤"		뒭
뒤#		뒺
뒤$		뒲
뒤%		뒱
뒤1		뒿
뒤2		뒸
뒤3		뒵
뒤A		뒫
뒤C		뒼
뒤D		뒯
뒤E		뒩
뒤F		뒮
뒤Q		뒾
뒤R		뒳
뒤S		뒪
뒤T		뒰
뒤V		뒧
뒤W		뒽
뒤X		뒶
뒤Z		뒻
뒤a		뒹
뒤q		뒷
뒤s		뒨
뒤w		뒬
뒤x		뒥
뒤z		뒴
듀!		듂
듀"		듉
듀#		듖
듀$		듎
듀%		듍
듀1		듛
듀2		듔
듀3		듑
듀A		듇
듀C		듘
듀D		듋
듀E		듅
듀F		듊
듀Q		듚
듀R		듏
듀S		듆
듀T		듌
듀V		듃
듀W		듙
듀X		듒
듀Z		듗
듀a		듕
듀q		듓
듀s		듄
듀w		듈
듀x		듁
듀z		듐
드!		듞
드"		듥
드#		듲
드$		듪
드%		듩
드1		듷
드2		듰
드3		듭
드A		듣
드C		듴
드D		듧
드E		듡
드F		듦
드Q		듶
드R		듫
드S		듢
드T		듨
드V		듟
드W		듵
드X		듮
드Z		듳
드a		등
드q		듯
드s		든
드w		들
드x		득
드z		듬
듸!		듺
듸"		딁
듸#		딎
듸$		딆
듸%		딅
듸1		딓
듸2		딌
듸3		딉
듸A		듿
듸C		딐
듸D		딃
듸E		듽
듸F		딂
듸Q		딒
듸R		딇
듸S		듾
듸T		딄
듸V		듻
듸W		딑
듸X		딊
듸Z		딏
듸a		딍
듸q		딋
듸s		듼
듸w		딀
듸x		듹
듸z		딈
디!		딖
디"		딝
디#		딪
디$		딢
디%		딡
디1		딯
디2		딨
디3		딥
디A		딛
디C		딬
디D		딟
디E		딙
디F		딞
디Q		딮
디R		딣
디S		딚
디T		딠
디V		딗
디W		딭
디X		딦
디Z		딫
디a		딩
디q		딧
디s		딘
디w		딜
디x		딕
디z		딤
따!		딲
따"		딹
따#		땆
따$		딾
따%		딽
따1		땋
따2		땄
따3		땁
따A		딷
따C		땈
따D		딻
따E		딵
따F		딺
따Q		땊
따R		딿
따S		딶
따T		딼
따V		딳
따W		땉
따X		땂
따Z		땇
따a		땅
따q		땃
따s		딴
따w		딸
따x		딱
따z		땀
때!		땎
때"		땕
때#		땢
때$		땚
때%		땙
때1		땧
때2		땠
때3		땝
때A		땓
때C		땤
때D		땗
때E		땑
때F		땖
때Q		땦
때R		땛
때S		땒
때T		땘
때V		땏
때W		땥
때X		땞
때Z		땣
때a		땡
때q		땟
때s		땐
때w		땔
때x		땍
때z		땜
땨!		땪
땨"		땱
땨#		땾
땨$		땶
땨%		땵
땨1		떃
땨2		땼
땨3		땹
땨A		땯
땨C		떀
땨D		땳
땨E		땭
땨F		땲
땨Q		떂
땨R		땷
땨S		땮
땨T		땴
땨V		땫
땨W		떁
땨X		땺
땨Z		땿
땨a		땽
땨q		땻
땨s		땬
땨w		땰
땨x		땩
땨z		땸
떄!		떆
떄"		떍
떄#		떚
떄$		떒
떄%		떑
떄1		떟
떄2		떘
떄3		떕
떄A		떋
떄C		떜
떄D		떏
떄E		떉
떄F		떎
떄Q		떞
떄R		떓
떄S		떊
떄T		떐
떄V		떇
떄W		떝
떄X		떖
떄Z		떛
떄a		떙
떄q		떗
떄s		떈
떄w		떌
떄x		떅
떄z		떔
떠!		떢
떠"		떩
떠#		떶
떠$		떮
떠%		떭
떠1		떻
떠2		떴
떠3		떱
떠A		떧
떠C		떸
떠D		떫
떠E		떥
떠F		떪
떠Q		떺
떠R		떯
떠S		떦
떠T		떬
떠V		떣
떠W		떹
떠X		떲
떠Z		떷
떠a		떵
떠q		떳
떠s		떤
떠w		떨
떠x		떡
떠z		떰
떼!		떾
떼"		뗅
떼#		뗒
떼$		뗊
떼%		뗉
떼1		뗗
떼2		뗐
떼3		뗍
떼A		뗃
떼C		뗔
떼D		뗇
떼E		뗁
떼F		뗆
떼Q		뗖
떼R		뗋
떼S		뗂
떼T		뗈
떼V		떿
떼W		뗕
떼X		뗎
떼Z		뗓
떼a		뗑
떼q		뗏
떼s		뗀
떼w		뗄
떼x		떽
떼z		뗌
뗘!		뗚
뗘"		뗡
뗘#		뗮
뗘$		뗦
뗘%		뗥
뗘1		뗳
뗘2		뗬
뗘3		뗩
뗘A		뗟
뗘C		뗰
뗘D		뗣
뗘E		뗝
뗘F		뗢
뗘Q		뗲
뗘R		뗧
뗘S		뗞
뗘T		뗤
뗘V		뗛
뗘W		뗱
뗘X		뗪
뗘Z		뗯
뗘a		뗭
뗘q		뗫
뗘s		뗜
뗘w		뗠
뗘x		뗙
뗘z		뗨
뗴!		뗶
뗴"		뗽
뗴#		똊
뗴$		똂
뗴%		똁
뗴1		똏
뗴2		똈
뗴3		똅
뗴A		뗻
뗴C		똌
뗴D		뗿
뗴E		뗹
뗴F		뗾
뗴Q		똎
뗴R		똃
뗴S		뗺
뗴T		똀
뗴V		뗷
뗴W		똍
뗴X		똆
뗴Z		똋
뗴a		똉
뗴q		똇
뗴s		뗸
뗴w		뗼
뗴x		뗵
뗴z		똄
또!		똒
또"		똙
또#		똦
또$		똞
또%		똝
또1		똫
또2		똤
또3		똡
또A		똗
또C		똨
또D		똛
또E		똕
또F		똚
또Q		똪
또R		똟
또S		똖
또T		똜
또V		똓
또W		똩
또X		똢
또Z		똧
또a		똥
또d		뙤
또f		똬
또q		똣
또r		뙈
또s		똔
또w		똘
또x		똑
또z		똠
똬!		똮
똬"		똵
똬#		뙂
똬$		똺
똬%		똹
똬1		뙇
똬2		뙀
똬3		똽
똬A		똳
똬C		뙄
똬D		똷
똬E		똱
똬F		똶
똬Q		뙆
똬R		똻
똬S		똲
똬T		똸
똬V		똯
똬W		뙅
똬X		똾
똬Z		뙃
똬a		뙁
똬q		똿
똬s		똰
똬w		똴
똬x		똭
똬z		똼
뙈!		뙊
뙈"		뙑
뙈#		뙞
뙈$		뙖
뙈%		뙕
뙈1		뙣
뙈2		뙜
뙈3		뙙
뙈A		뙏
뙈C		뙠
뙈D		뙓
뙈E		뙍
뙈F		뙒
뙈Q		뙢
뙈R		뙗
뙈S		뙎
뙈T		뙔
뙈V		뙋
뙈W		뙡
뙈X		뙚
뙈Z		뙟
뙈a		뙝
뙈q		뙛
뙈s		뙌
뙈w		뙐
뙈x		뙉
뙈z		뙘
뙤!		뙦
뙤"		뙭
뙤#		뙺
뙤$		뙲
뙤%		뙱
뙤1		뙿
뙤2		뙸
뙤3		뙵
뙤A		뙫
뙤C		뙼
뙤D		뙯
뙤E		뙩
뙤F		뙮
뙤Q		뙾
뙤R		뙳
뙤S		뙪
뙤T		뙰
뙤V		뙧
뙤W		뙽
뙤X		뙶
뙤Z		뙻
뙤a		뙹
뙤q		뙷
뙤s		뙨
뙤w		뙬
뙤x		뙥
뙤z		뙴
뚀!		뚂
뚀"		뚉
뚀#		뚖
뚀$		뚎
뚀%		뚍
뚀1		뚛
뚀2		뚔
뚀3		뚑
뚀A		뚇
뚀C		뚘
뚀D		뚋
뚀E		뚅
뚀F		뚊
뚀Q		뚚
뚀R		뚏
뚀S		뚆
뚀T		뚌
뚀V		뚃
뚀W		뚙
뚀X		뚒
뚀Z		뚗
뚀a		뚕
뚀q		뚓
뚀s		뚄
뚀w		뚈
뚀x		뚁
뚀z		뚐
뚜!		뚞
뚜"		뚥
뚜#		뚲
뚜$		뚪
뚜%		뚩
뚜1		뚷
뚜2		뚰
뚜3		뚭
뚜A		뚣
뚜C		뚴
뚜D		뚧
뚜E		뚡
뚜F		뚦
뚜Q		뚶
뚜R		뚫
뚜S		뚢
뚜T		뚨
뚜V		뚟
뚜W		뚵
뚜X		뚮
뚜Z		뚳
뚜a		뚱
뚜c		뛔
뚜d		뛰
뚜q		뚯
뚜s		뚠
뚜t		뚸
뚜w		뚤
뚜x		뚝
뚜z		뚬
뚸!		뚺
뚸"		뛁
뚸#		뛎
뚸$		뛆
뚸%		뛅
뚸1		뛓
뚸2		뛌
뚸3		뛉
뚸A		뚿
뚸C		뛐
뚸D		뛃
뚸E		뚽
뚸F		뛂
뚸Q		뛒
뚸R		뛇
뚸S		뚾
뚸T		뛄
뚸V		뚻
뚸W		뛑
뚸X		뛊
뚸Z		뛏
뚸a		뛍
뚸q		뛋
뚸s		뚼
뚸w		뛀
뚸x		뚹
뚸z		뛈
뛔!		뛖
뛔"		뛝
뛔#		뛪
뛔$		뛢
뛔%		뛡
뛔1		뛯
뛔2		뛨
뛔3		뛥
뛔A		뛛
뛔C		뛬
뛔D		뛟
뛔E		뛙
뛔F		뛞
뛔Q		뛮
뛔R		뛣
뛔S		뛚
뛔T		뛠
뛔V		뛗
뛔W		뛭
뛔X		뛦
뛔Z		뛫
뛔a		뛩
뛔q		뛧
뛔s		뛘
뛔w		뛜
뛔x		뛕
뛔z		뛤
뛰!		뛲
뛰"		뛹
뛰#		뜆
뛰$		뛾
뛰%		뛽
뛰1		뜋
뛰2		뜄
뛰3		뜁
뛰A		뛷
뛰C		뜈
뛰D		뛻
뛰E		뛵
뛰F		뛺
뛰Q		뜊
뛰R		뛿
뛰S		뛶
뛰T		뛼
뛰V		뛳
뛰W		뜉
뛰X		뜂
뛰Z		뜇
뛰a		뜅
뛰q		뜃
뛰s		뛴
뛰w		뛸
뛰x		뛱
뛰z		뜀
뜌!		뜎
뜌"		뜕
뜌#		뜢
뜌$		뜚
뜌%		뜙
뜌1		뜧
뜌2		뜠
뜌3		뜝
뜌A		뜓
뜌C		뜤
뜌D		뜗
뜌E		뜑
뜌F		뜖
뜌Q		뜦
뜌R		뜛
뜌S		뜒
뜌T		뜘
뜌V		뜏
뜌W		뜥
뜌X		뜞
뜌Z		뜣
뜌a		뜡
뜌q		뜟
뜌s		뜐
뜌w		뜔
뜌x		뜍
뜌z		뜜
뜨!		뜪
뜨"		뜱
뜨#		뜾
뜨$		뜶
뜨%		뜵
뜨1		띃
뜨2		뜼
뜨3		뜹
뜨A		뜯
뜨C		띀
뜨D		뜳
뜨E		뜭
뜨F		뜲
뜨Q		띂
뜨R		뜷
뜨S		뜮
뜨T		뜴
뜨V		뜫
뜨W		띁
뜨X		뜺
뜨Z		뜿
뜨a		뜽
뜨q		뜻
뜨s		뜬
뜨w		뜰
뜨x		뜩
뜨z		뜸
띄!		띆
띄"		띍
띄#		띚
띄$		띒
띄%		띑
띄1		띟
띄2		띘
띄3		띕
띄A		띋
띄C		띜
띄D		띏
띄E		띉
띄F		띎
띄Q		띞
띄R		띓
띄S		띊
띄T		띐
띄V		띇
띄W		띝
띄X		띖
띄Z		띛
띄a		띙
띄q		띗
띄s		띈
띄w		띌
띄x		띅
띄z		띔
띠!		띢
띠"		띩
띠#		띶
띠$		띮
띠%		띭
띠1		띻
띠2		띴
띠3		띱
띠A		띧
띠C		띸
띠D		띫
띠E		띥
띠F		띪
띠Q		띺
띠R		띯
띠S		띦
띠T		띬
띠V		띣
띠W		띹
띠X		띲
띠Z		띷
띠a		띵
띠q		띳
띠s		띤
띠w		띨
띠x		띡
띠z		띰
라!		띾
라"		랅
라#		랒
라$		랊
라%		랉
라1		랗
라2		랐
라3		랍
라A		랃
라C		랔
라D		랇
라E		랁
라F		랆
라Q		랖
라R		랋
라S		랂
라T		랈
라V		띿
라W		랕
라X		랎
라Z		랓
라a		랑
라q		랏
라s		란
라w		랄
라x		락
라z		람
래!		랚
래"		랡
래#		랮
래$		랦
래%		랥
래1		랳
래2		랬
래3		랩
래A		랟
래C		랰
래D		랣
래E		랝
래F		랢
래Q		랲
래R		랧
래S		랞
래T		랤
래V		랛
래W		랱
래X		랪
래Z		랯
래a		랭
래q		랫
래s		랜
래w		랠
래x		랙
래z		램
랴!		랶
랴"		랽
랴#		럊
랴$		럂
랴%		럁
랴1		럏
랴2		럈
랴3		럅
랴A		랻
랴C		럌
랴D		랿
랴E		랹
랴F		랾
랴Q		럎
랴R		럃
랴S		랺
랴T		럀
랴V		랷
랴W		럍
랴X		럆
랴Z		럋
랴a		량
랴q		럇
랴s		랸
랴w		랼
랴x		략
랴z		럄
럐!		럒
럐"		럙
럐#		럦
럐$		럞
럐%		럝
럐1		럫
럐2		럤
럐3		럡
럐A		럗
럐C		럨
럐D		럛
럐E		럕
럐F		럚
럐Q		럪
럐R		럟
럐S		럖
럐T		럜
럐V		럓
럐W		럩
럐X		럢
럐Z		럧
럐a		럥
럐q		럣
럐s		럔
럐w		럘
럐x		럑
럐z		럠
러!		럮
러"		럵
러#		렂
러$		럺
러%		럹
러1		렇
러2		렀
러3		럽
러A		럳
러C		렄
러D		럷
러E		럱
러F		럶
러Q		렆
러R		럻
러S		럲
러T		럸
러V		럯
러W		렅
러X		럾
러Z		렃
러a		렁
러q		럿
러s		런
러w		럴
러x		럭
러z		럼
레!		렊
레"		렑
레#		렞
레$		렖
레%		렕
레1		렣
레2		렜
레3		렙
레A		렏
레C		렠
레D		렓
레E		렍
레F		렒
레Q		렢
레R		렗
레S		렎
레T		렔
레V		렋
레W		렡
레X		렚
레Z		렟
레a		렝
레q		렛
레s		렌
레w		렐
레x		렉
레z		렘
려!		렦
려"		렭
려#		렺
려$		렲
려%		렱
려1		렿
려2		렸
려3		렵
려A		렫
려C		렼
려D		렯
려E		렩
려F		렮
려Q		렾
려R		렳
려S		렪
려T		렰
려V		렧
려W		렽
려X		렶
려Z		렻
려a		령
려q		렷
려s		련
려w		렬
려x		력
려z		렴
례!		롂
례"		롉
례#		롖
례$		롎
례%		롍
례1		롛
례2		롔
례3		롑
례A		롇
례C		롘
례D		롋
례E		롅
례F		롊
례Q		롚
례R		롏
례S		롆
례T		롌
례V		롃
례W		롙
례X		롒
례Z		롗
례a		롕
례q		롓
례s		롄
례w		롈
례x		롁
례z		롐
로!		롞
로"		롥
로#		롲
로$		롪
로%		롩
로1		롷
로2		롰
로3		롭
로A		롣
로C		롴
로D		롧
로E		롡
로F		롦
로Q		롶
로R		롫
로S		롢
로T		롨
로V		롟
로W		롵
로X		롮
로Z		롳
로a		롱
로d		뢰
로f		롸
로q		롯
로r		뢔
로s		론
로w		롤
로x		록
로z		롬
롸!		롺
롸"		뢁
롸#		뢎
롸$		뢆
롸%		뢅
롸1		뢓
롸2		뢌
롸3		뢉
롸A		롿
롸C		뢐
롸D		뢃
롸E		롽
롸F		뢂
롸Q		뢒
롸R		뢇
롸S		롾
롸T		뢄
롸V		롻
롸W		뢑
롸X		뢊
롸Z		뢏
롸a		뢍
롸q		뢋
롸s		롼
롸w		뢀
롸x		롹
롸z		뢈
뢔!		뢖
뢔"		뢝
뢔#		뢪
뢔$		뢢
뢔%		뢡
뢔1		뢯
뢔2		뢨
뢔3		뢥
뢔A		뢛
뢔C		뢬
뢔D		뢟
뢔E		뢙
뢔F		뢞
뢔Q		뢮
뢔R		뢣
뢔S		뢚
뢔T		뢠
뢔V		뢗
뢔W		뢭
뢔X		뢦
뢔Z		뢫
뢔a		뢩
뢔q		뢧
뢔s		뢘
뢔w		뢜
뢔x		뢕
뢔z		뢤
뢰!		뢲
뢰"		뢹
뢰#		룆
뢰$		뢾
뢰%		뢽
뢰1		룋
뢰2		룄
뢰3		룁
뢰A		뢷
뢰C		룈
뢰D		뢻
뢰E		뢵
뢰F		뢺
뢰Q		룊
뢰R		뢿
뢰S		뢶
뢰T		뢼
뢰V		뢳
뢰W		룉
뢰X		룂
뢰Z		룇
뢰a		룅
뢰q		룃
뢰s		뢴
뢰w		뢸
뢰x		뢱
뢰z		룀
료!		룎
료"		룕
료#		룢
료$		룚
료%		룙
료1		룧
료2		룠
료3		룝
료A		룓
료C		룤
료D		룗
료E		룑
료F		룖
료Q		룦
료R		룛
료S		룒
료T		룘
료V		룏
료W		룥
료X		룞
료Z		룣
료a		룡
료q		룟
료s		룐
료w		룔
료x		룍
료z		룜
루!		룪
루"		룱
루#		룾
루$		룶
루%		룵
루1		뤃
루2		룼
루3		룹
루A		룯
루C		뤀
루D		룳
루E		룭
루F		룲
루Q		뤂
루R		룷
루S		룮
루T		룴
루V		룫
루W		뤁
루X		룺
루Z		룿
루a		룽
루c		뤠
루d		뤼
루q		룻
루s		룬
루t		뤄
루w		룰
루x		룩
루z		룸
뤄!		뤆
뤄"		뤍
뤄#		뤚
뤄$		뤒
뤄%		뤑
뤄1		뤟
뤄2		뤘
뤄3		뤕
뤄A		뤋
뤄C		뤜
뤄D		뤏
뤄E		뤉
뤄F		뤎
뤄Q		뤞
뤄R		뤓
뤄S		뤊
뤄T		뤐
뤄V		뤇
뤄W		뤝
뤄X		뤖
뤄Z		뤛
뤄a		뤙
뤄q		뤗
뤄s		뤈
뤄w		뤌
뤄x		뤅
뤄z		뤔
뤠!		뤢
뤠"		뤩
뤠#		뤶
뤠$		뤮
뤠%		뤭
뤠1		뤻
뤠2		뤴
뤠3		뤱
뤠A		뤧
뤠C		뤸
뤠D		뤫
뤠E		뤥
뤠F		뤪
뤠Q		뤺
뤠R		뤯
뤠S		뤦
뤠T		뤬
뤠V		뤣
뤠W		뤹
뤠X		뤲
뤠Z		뤷
뤠a		뤵
뤠q		뤳
뤠s		뤤
뤠w		뤨
뤠x		뤡
뤠z		뤰
뤼!		뤾
뤼"		륅
뤼#		륒
뤼$		륊
뤼%		륉
뤼1		륗
뤼2		륐
뤼3		륍
뤼A		륃
뤼C		륔
뤼D		륇
뤼E		륁
뤼F		륆
뤼Q		륖
뤼R		륋
뤼S		륂
뤼T		륈
뤼V		뤿
뤼W		륕
뤼X		륎
뤼Z		륓
뤼a		륑
뤼q		륏
뤼s		륀
뤼w		륄
뤼x		뤽
뤼z		륌
류!		륚
류"		륡
류#		륮
류$		륦
류%		륥
류1		륳
류2		륬
류3		륩
류A		륟
류C		륰
류D		륣
류E		륝
류F		륢
류Q		륲
류R		륧
류S		륞
류T		륤
류V		륛
류W		륱
류X		륪
류Z		륯
류a		륭
류q		륫
류s		륜
류w		률
류x		륙
류z		륨
르!		륶
르"		륽
르#		릊
르$		릂
르%		릁
르1		릏
르2		릈
르3		릅
르A		륻
르C		릌
르D		륿
르E		륹
르F		륾
르Q		릎
르R		릃
르S		륺
르T		릀
르V		륷
르W		릍
르X		릆
르Z		릋
르a		릉
르q		릇
르s		른
르w		를
르x		륵
르z		름
릐!		릒
릐"		릙
릐#		릦
릐$		릞
릐%		릝
릐1		릫
릐2		릤
릐3		릡
릐A		릗
릐C		릨
릐D		릛
릐E		릕
릐F		릚
릐Q		릪
릐R		릟
릐S		릖
릐T		릜
릐V		릓
릐W		릩
릐X		릢
릐Z		릧
릐a		릥
릐q		릣
릐s		릔
릐w		릘
릐x		릑
릐z		릠
리!		릮
리"		릵
리#		맂
리$		릺
리%		릹
리1		맇
리2		맀
리3		립
리A		릳
리C		맄
리D		릷
리E		릱
리F		릶
리Q		맆
리R		릻
리S		릲
리T		릸
리V		릯
리W		맅
리X		릾
리Z		맃
리a		링
리q		릿
리s		린
리w		릴
리x		릭
리z		림
마!		맊
마"		맑
마#		맞
마$		맖
마%		맕
마1		맣
마2		맜
마3		맙
마A		맏
마C		맠
마D		맓
마E		맍
마F		맒
마Q		맢
마R		맗
마S		많
마T		맔
마V		맋
마W		맡
마X		맚
마Z		맟
마a		망
마q		맛
마s		만
마w		말
마x		막
마z		맘
매!		맦
매"		맭
매#		맺
매$		맲
매%		맱
매1		맿
매2		맸
매3		맵
매A		맫
매C		맼
매D		맯
매E		맩
매F		맮
매Q		맾
매R		맳
매S		맪
매T		맰
매V		맧
매W		맽
매X		맶
매Z		맻
매a		맹
매q		맷
매s		맨
매w		맬
매x		맥
매z		맴
먀!		먂
먀"		먉
먀#		먖
먀$		먎
먀%		먍
먀1		먛
먀2		먔
먀3		먑
먀A		먇
먀C		먘
먀D		먋
먀E		먅
먀F		먊
먀Q		먚
먀R		먏
먀S		먆
먀T		먌
먀V		먃
먀W		먙
먀X		먒
먀Z		먗
먀a		먕
먀q		먓
먀s		먄
먀w		먈
먀x		먁
먀z		먐
먜!		먞
먜"		먥
먜#		먲
먜$		먪
먜%		먩
먜1		먷
먜2		먰
먜3		먭
먜A		먣
먜C		먴
먜D		먧
먜E		먡
먜F		먦
먜Q		먶
먜R		먫
먜S		먢
먜T		먨
먜V		먟
먜W		먵
먜X		먮
먜Z		먳
먜a		먱
먜q		먯
먜s		먠
먜w		먤
먜x		먝
먜z		먬
머!		먺
머"		멁
머#		멎
머$		멆
머%		멅
머1		멓
머2		멌
머3		멉
머A		먿
머C		멐
머D		멃
머E		먽
머F		멂
머Q		멒
머R		멇
머S		먾
머T		멄
머V		먻
머W		멑
머X		멊
머Z		멏
머a		멍
머q		멋
머s		먼
머w		멀
머x		먹
머z		멈
메!		멖
메"		멝
메#		멪
메$		멢
메%		멡
메1		멯
메2		멨
메3		멥
메A		멛
메C		멬
메D		멟
메E		멙
메F		멞
메Q		멮
메R		멣
메S		멚
메T		멠
메V		멗
메W		멭
메X		멦
메Z		멫
메a		멩
메q		멧
메s		멘
메w		멜
메x		멕
메z		멤
며!		멲
며"		멹
며#		몆
며$		멾
며%		멽
며1		몋
며2		몄
며3		몁
며A		멷
며C		몈
며D		멻
며E		멵
며F		멺
며Q		몊
며R		멿
며S		멶
며T		멼
며V		멳
며W		몉
며X		몂
며Z		몇
며a		명
며q		몃
며s		면
며w		멸
며x		멱
며z		몀
몌!		몎
몌"		몕
몌#		몢
몌$		몚
몌%		몙
몌1		몧
몌2		몠
몌3		몝
몌A		몓
몌C		몤
몌D		몗
몌E		몑
몌F		몖
몌Q		몦
몌R		몛
몌S		몒
몌T		몘
몌V		몏
몌W		몥
몌X		몞
몌Z		몣
몌a		몡
몌q		몟
몌s		몐
몌w		몔
몌x		몍
몌z		몜
모!		몪
모"		몱
모#		몾
모$		몶
모%		몵
모1		뫃
모2		몼
모3		몹
모A		몯
모C		뫀
모D		몳
모E		몭
모F		몲
모Q		뫂
모R		몷
모S		몮
모T		몴
모V		몫
모W		뫁
모X		몺
모Z		몿
모a		몽
모d		뫼
모f		뫄
모q		못
모r		뫠
모s		몬
모w		몰
모x		목
모z		몸
뫄!		뫆
뫄"		뫍
뫄#		뫚
뫄$		뫒
뫄%		뫑
뫄1		뫟
뫄2		뫘
뫄3		뫕
뫄A		뫋
뫄C		뫜
뫄D		뫏
뫄E		뫉
뫄F		뫎
뫄Q		뫞
뫄R		뫓
뫄S		뫊
뫄T		뫐
뫄V		뫇
뫄W		뫝
뫄X		뫖
뫄Z		뫛
뫄a		뫙
뫄q		뫗
뫄s		뫈
뫄w		뫌
뫄x		뫅
뫄z		뫔
뫠!		뫢
뫠"		뫩
뫠#		뫶
뫠$		뫮
뫠%		뫭
뫠1		뫻
뫠2		뫴
뫠3		뫱
뫠A		뫧
뫠C		뫸
뫠D		뫫
뫠E		뫥
뫠F		뫪
뫠Q		뫺
뫠R		뫯
뫠S		뫦
뫠T		뫬
뫠V		뫣
뫠W		뫹
뫠X		뫲
뫠Z		뫷
뫠a		뫵
뫠q		뫳
뫠s		뫤
뫠w		뫨
뫠x		뫡
뫠z		뫰
뫼!		뫾
뫼"		묅
뫼#		묒
뫼$		묊
뫼%		묉
뫼1		묗
뫼2		묐
뫼3		묍
뫼A		묃
뫼C		묔
뫼D		묇
뫼E		묁
뫼F		묆
뫼Q		묖
뫼R		묋
뫼S		묂
뫼T		묈
뫼V		뫿
뫼W		묕
뫼X		묎
뫼Z		묓
뫼a		묑
뫼q		묏
뫼s		묀
뫼w		묄
뫼x		뫽
뫼z		묌
묘!		묚
묘"		묡
묘#		묮
묘$		묦
묘%		묥
묘1		묳
묘2		묬
묘3		묩
묘A		묟
묘C		묰
묘D		묣
묘E		묝
묘F		묢
묘Q		묲
묘R		묧
묘S		묞
묘T		묤
묘V		묛
묘W		묱
묘X		묪
묘Z		묯
묘a		묭
묘q		묫
묘s		묜
묘w		묠
묘x		묙
묘z		묨
무!		묶
무"		묽
무#		뭊
무$		뭂
무%		뭁
무1		뭏
무2		뭈
무3		뭅
무A		묻
무C		뭌
무D		묿
무E		묹
무F		묾
무Q		뭎
무R		뭃
무S		묺
무T		뭀
무V		묷
무W		뭍
무X		뭆
무Z		뭋
무a		뭉
무c		뭬
무d		뮈
무q		뭇
무s		문
무t		뭐
무w		물
무x		묵
무z		뭄
뭐!		뭒
뭐"		뭙
뭐#		뭦
뭐$		뭞
뭐%		뭝
뭐1		뭫
뭐2		뭤
뭐3		뭡
뭐A		뭗
뭐C		뭨
뭐D		뭛
뭐E		뭕
뭐F		뭚
뭐Q		뭪
뭐R		뭟
뭐S		뭖
뭐T		뭜
뭐V		뭓
뭐W		뭩
뭐X		뭢
뭐Z		뭧
뭐a		뭥
뭐q		뭣
뭐s		뭔
뭐w		뭘
뭐x		뭑
뭐z		뭠
뭬!		뭮
뭬"		뭵
뭬#		뮂
뭬$		뭺
뭬%		뭹
뭬1		뮇
뭬2		뮀
뭬3		뭽
뭬A		뭳
뭬C		뮄
뭬D		뭷
뭬E		뭱
뭬F		뭶
뭬Q		뮆
뭬R		뭻
뭬S		뭲
뭬T		뭸
뭬V		뭯
뭬W		뮅
뭬X		뭾
뭬Z		뮃
뭬a		뮁
뭬q		뭿
뭬s		뭰
뭬w		뭴
뭬x		뭭
뭬z		뭼
뮈!		뮊
뮈"		뮑
뮈#		뮞
뮈$		뮖
뮈%		뮕
뮈1		뮣
뮈2		뮜
뮈3		뮙
뮈A		뮏
뮈C		뮠
뮈D		뮓
뮈E		뮍
뮈F		뮒
뮈Q		뮢
뮈R		뮗
뮈S		뮎
뮈T		뮔
뮈V		뮋
뮈W		뮡
뮈X		뮚
뮈Z		뮟
뮈a		뮝
뮈q		뮛
뮈s		뮌
뮈w		뮐
뮈x		뮉
뮈z		뮘
뮤!		뮦
뮤"		뮭
뮤#		뮺
뮤$		뮲
뮤%		뮱
뮤1		뮿
뮤2		뮸
뮤3		뮵
뮤A		뮫
뮤C		뮼
뮤D		뮯
뮤E		뮩
뮤F		뮮
뮤Q		뮾
뮤R		뮳
뮤S		뮪
뮤T		뮰
뮤V		뮧
뮤W		뮽
뮤X		뮶
뮤Z		뮻
뮤a		뮹
뮤q		뮷
뮤s		뮨
뮤w		뮬
뮤x		뮥
뮤z		뮴
므!		믂
므"		믉
므#		믖
므$		믎
므%		믍
므1		믛
므2		믔
므3		믑
므A		믇
므C		믘
므D		믋
므E		믅
므F		믊
므Q		믚
므R		믏
므S		믆
므T		믌
므V		믃
므W		믙
므X		믒
므Z		믗
므a		믕
므q		믓
므s		믄
므w		믈
므x		믁
므z		믐
믜!		믞
믜"		믥
믜#		믲
믜$		믪
믜%		믩
믜1		믷
믜2		믰
믜3		믭
믜A		믣
믜C		믴
믜D		믧
믜E		믡
믜F		믦
믜Q		믶
믜R		믫
믜S		믢
믜T		믨
믜V		믟
믜W		믵
믜X		믮
믜Z		믳
믜a		믱
믜q		믯
믜s		믠
믜w		믤
믜x		믝
믜z		믬
미!		믺
미"		밁
미#		밎
미$		밆
미%		밅
미1		밓
미2		밌
미3		밉
미A		믿
미C		밐
미D		밃
미E		믽
미F		밂
미Q		밒
미R		밇
미S		믾
미T		밄
미V		믻
미W		밑
미X		밊
미Z		및
미a		밍
미q		밋
미s		민
미w		밀
미x		믹
미z		밈
바!		밖
바"		밝
바#		밪
바$		밢
바%		밡
바1		밯
바2		밨
바3		밥
바A		받
바C		밬
바D		밟
바E		밙
바F		밞
바Q		밮
바R		밣
바S		밚
바T		밠
바V		밗
바W		밭
바X		밦
바Z		밫
바a		방
바q		밧
바s		반
바w		발
바x		박
바z		밤
배!		밲
배"		밹
배#		뱆
배$		밾
배%		밽
배1		뱋
배2		뱄
배3		뱁
배A		밷
배C		뱈
배D		밻
배E		밵
배F		밺
배Q		뱊
배R		밿
배S		밶
배T		밼
배V		밳
배W		뱉
배X		뱂
배Z		뱇
배a		뱅
배q		뱃
배s		밴
배w		밸
배x		백
배z		뱀
뱌!		뱎
뱌"		뱕
뱌#		뱢
뱌$		뱚
뱌%		뱙
뱌1		뱧
뱌2		뱠
뱌3		뱝
뱌A		뱓
뱌C		뱤
뱌D		뱗
뱌E		뱑
뱌F		뱖
뱌Q		뱦
뱌R		뱛
뱌S		뱒
뱌T		뱘
뱌V		뱏
뱌W		뱥
뱌X		뱞
뱌Z		뱣
뱌a		뱡
뱌q		뱟
뱌s		뱐
뱌w		뱔
뱌x		뱍
뱌z		뱜
뱨!		뱪
뱨"		뱱
뱨#		뱾
뱨$		뱶
뱨%		뱵
뱨1		벃
뱨2		뱼
뱨3		뱹
뱨A		뱯
뱨C		벀
뱨D		뱳
뱨E		뱭
뱨F		뱲
뱨Q		벂
뱨R		뱷
뱨S		뱮
뱨T		뱴
뱨V		뱫
뱨W		벁
뱨X		뱺
뱨Z		뱿
뱨a		뱽
뱨q		뱻
뱨s		뱬
뱨w		뱰
뱨x		뱩
뱨z		뱸
버!		벆
버"		벍
버#		벚
버$		벒
버%		벑
버1		벟
버2		벘
버3		법
버A		벋
버C		벜
버D		벏
버E		벉
버F		벎
버Q		벞
버R		벓
버S		벊
버T		벐
버V		벇
버W		벝
버X		벖
버Z		벛
버a		벙
버q		벗
버s		번
버w		벌
버x		벅
버z		범
베!		벢
베"		벩
베#		벶
베$		벮
베%		벭
베1		벻
베2		벴
베3		벱
베A		벧
베C		벸
베D		벫
베E		벥
베F		벪
베Q		벺
베R		벯
베S		벦
베T		벬
베V		벣
베W		벹
베X		벲
베Z		벷
베a		벵
베q		벳
베s		벤
베w		벨
베x		벡
베z		벰
벼!		벾
벼"		볅
벼#		볒
벼$		볊
벼%		볉
벼1		볗
벼2		볐
벼3		볍
벼A		볃
벼C		볔
벼D		볇
벼E		볁
벼F		볆
벼Q		볖
벼R		볋
벼S		볂
벼T		볈
벼V		벿
벼W		볕
벼X		볎
벼Z		볓
벼a		병
벼q		볏
벼s		변
벼w		별
벼x		벽
벼z		볌
볘!		볚
볘"		볡
볘#		볮
볘$		볦
볘%		볥
볘1		볳
볘2		볬
볘3		볩
볘A		볟
볘C		볰
볘D		볣
볘E		볝
볘F		볢
볘Q		볲
볘R		볧
볘S		볞
볘T		볤
볘V		볛
볘W		볱
볘X		볪
볘Z		볯
볘a		볭
볘q		볫
볘s		볜
볘w		볠
볘x		볙
볘z		볨
보!		볶
보"		볽
보#		봊
보$		봂
보%		봁
보1		봏
보2		봈
보3		봅
보A		볻
보C		봌
보D		볿
보E		볹
보F		볾
보Q		봎
보R		봃
보S		볺
보T		봀
보V		볷
보W		봍
보X		봆
보Z		봋
보a		봉
보d		뵈
보f		봐
보q		봇
보r		봬
보s		본
보w		볼
보x		복
보z		봄
봐!		봒
봐"		봙
봐#		봦
봐$		봞
봐%		봝
봐1		봫
봐2		봤
봐3		봡
봐A		봗
봐C		봨
봐D		봛
봐E		봕
봐F		봚
봐Q		봪
봐R		봟
봐S		봖
봐T		봜
봐V		봓
봐W		봩
봐X		봢
봐Z		봧
봐a		봥
봐q		봣
봐s		봔
봐w		봘
봐x		봑
봐z		봠
봬!		봮
봬"		봵
봬#		뵂
봬$		봺
봬%		봹
봬1		뵇
봬2		뵀
봬3		봽
봬A		봳
봬C		뵄
봬D		봷
봬E		봱
봬F		봶
봬Q		뵆
봬R		봻
봬S		봲
봬T		봸
봬V		봯
봬W		뵅
봬X		봾
봬Z		뵃
봬a		뵁
봬q		봿
봬s		봰
봬w		봴
봬x		봭
봬z		봼
뵈!		뵊
뵈"		뵑
뵈#		뵞
뵈$		뵖
뵈%		뵕
뵈1		뵣
뵈2		뵜
뵈3		뵙
뵈A		뵏
뵈C		뵠
뵈D		뵓
뵈E		뵍
뵈F		뵒
뵈Q		뵢
뵈R		뵗
뵈S		뵎
뵈T		뵔
뵈V		뵋
뵈W		뵡
뵈X		뵚
뵈Z		뵟
뵈a		뵝
뵈q		뵛
뵈s		뵌
뵈w		뵐
뵈x		뵉
뵈z		뵘
뵤!		뵦
뵤"		뵭
뵤#		뵺
뵤$		뵲
뵤%		뵱
뵤1		뵿
뵤2		뵸
뵤3		뵵
뵤A		뵫
뵤C		뵼
뵤D		뵯
뵤E		뵩
뵤F		뵮
뵤Q		뵾
뵤R		뵳
뵤S		뵪
뵤T		뵰
뵤V		뵧
뵤W		뵽
뵤X		뵶
뵤Z		뵻
뵤a		뵹
뵤q		뵷
뵤s		뵨
뵤w		뵬
뵤x		뵥
뵤z		뵴
부!		붂
부"		붉
부#		붖
부$		붎
부%		붍
부1		붛
부2		붔
부3		붑
부A		붇
부C		붘
부D		붋
부E		붅
부F		붊
부Q		붚
부R		붏
부S		붆
부T		붌
부V		붃
부W		붙
부X		붒
부Z		붗
부a		붕
부c		붸
부d		뷔
부q		붓
부s		분
부t		붜
부w		불
부x		북
부z		붐
붜!		붞
붜"		붥
붜#		붲
붜$		붪
붜%		붩
붜1		붷
붜2		붰
붜3		붭
붜A		붣
붜C		붴
붜D		붧
붜E		붡
붜F		붦
붜Q		붶
붜R		붫
붜S		붢
붜T		붨
붜V		붟
붜W		붵
붜X		붮
붜Z		붳
붜a		붱
붜q		붯
붜s		붠
붜w		붤
붜x		붝
붜z		붬
붸!		붺
붸"		뷁
붸#		뷎
붸$		뷆
붸%		뷅
붸1		뷓
붸2		뷌
붸3		뷉
붸A		붿
붸C		뷐
붸D		뷃
붸E		붽
붸F		뷂
붸Q		뷒
붸R		뷇
붸S		붾
붸T		뷄
붸V		붻
붸W		뷑
붸X		뷊
붸Z		뷏
붸a		뷍
붸q		뷋
붸s		붼
붸w		뷀
붸x		붹
붸z		뷈
뷔!		뷖
뷔"		뷝
뷔#		뷪
뷔$		뷢
뷔%		뷡
뷔1		뷯
뷔2		뷨
뷔3		뷥
뷔A		뷛
뷔C		뷬
뷔D		뷟
뷔E		뷙
뷔F		뷞
뷔Q		뷮
뷔R		뷣
뷔S		뷚
뷔T		뷠
뷔V		뷗
뷔W		뷭
뷔X		뷦
뷔Z		뷫
뷔a		뷩
뷔q		뷧
뷔s		뷘
뷔w		뷜
뷔x		뷕
뷔z		뷤
뷰!		뷲
뷰"		뷹
뷰#		븆
뷰$		뷾
뷰%		뷽
뷰1		븋
뷰2		븄
뷰3		븁
뷰A		뷷
뷰C		븈
뷰D		뷻
뷰E		뷵
뷰F		뷺
뷰Q		븊
뷰R		뷿
뷰S		뷶
뷰T		뷼
뷰V		뷳
뷰W		븉
뷰X		븂
뷰Z		븇
뷰a		븅
뷰q		븃
뷰s		뷴
뷰w		뷸
뷰x		뷱
뷰z		븀
브!		븎
브"		븕
브#		븢
브$		븚
브%		븙
브1		븧
브2		븠
브3		븝
브A		븓
브C		븤
브D		븗
브E		븑
브F		븖
브Q		븦
브R		븛
브S		븒
브T		븘
브V		븏
브W		븥
브X		븞
브Z		븣
브a		븡
브q		븟
브s		븐
브w		블
브x		븍
브z		븜
븨!		븪
븨"		븱
븨#		븾
븨$		븶
븨%		븵
븨1		빃
븨2		븼
븨3		븹
븨A		븯
븨C		빀
븨D		븳
븨E		븭
븨F		븲
븨Q		빂
븨R		븷
븨S		븮
븨T		븴
븨V		븫
븨W		빁
븨X		븺
븨Z		븿
븨a		븽
븨q		븻
븨s		븬
븨w		븰
븨x		븩
븨z		븸
비!		빆
비"		빍
비#		빚
비$		빒
비%		빑
비1		빟
비2		빘
비3		빕
비A		빋
비C		빜
비D		빏
비E		빉
비F		빎
비Q		빞
비R		빓
비S		빊
비T		빐
비V		빇
비W		빝
비X		빖
비Z		빛
비a		빙
비q		빗
비s		빈
비w		빌
비x		빅
비z		빔
빠!		빢
빠"		빩
빠#		빶
빠$		빮
빠%		빭
빠1		빻
빠2		빴
빠3		빱
빠A		빧
빠C		빸
빠D		빫
빠E		빥
빠F		빪
빠Q		빺
빠R		빯
빠S		빦
빠T		빬
빠V		빣
빠W		빹
빠X		빲
빠Z		빷
빠a		빵
빠q		빳
빠s		빤
빠w		빨
빠x		빡
빠z		빰
빼!		빾
빼"		뺅
빼#		뺒
빼$		뺊
빼%		뺉
빼1		뺗
빼2		뺐
빼3		뺍
빼A		뺃
빼C		뺔
빼D		뺇
빼E		뺁
빼F		뺆
빼Q		뺖
빼R		뺋
빼S		뺂
빼T		뺈
빼V		빿
빼W		뺕
빼X		뺎
빼Z		뺓
빼a		뺑
빼q		뺏
빼s		뺀
빼w		뺄
빼x		빽
빼z		뺌
뺘!		뺚
뺘"		뺡
뺘#		뺮
뺘$		뺦
뺘%		뺥
뺘1		뺳
뺘2		뺬
뺘3		뺩
뺘A		뺟
뺘C		뺰
뺘D		뺣
뺘E		뺝
뺘F		뺢
뺘Q		뺲
뺘R		뺧
뺘S		뺞
뺘T		뺤
뺘V		뺛
뺘W		뺱
뺘X		뺪
뺘Z		뺯
뺘a		뺭
뺘q		뺫
뺘s		뺜
뺘w		뺠
뺘x		뺙
뺘z		뺨
뺴!		뺶
뺴"		뺽
뺴#		뻊
뺴$		뻂
뺴%		뻁
뺴1		뻏
뺴2		뻈
뺴3		뻅
뺴A		뺻
뺴C		뻌
뺴D		뺿
뺴E		뺹
뺴F		뺾
뺴Q		뻎
뺴R		뻃
뺴S		뺺
뺴T		뻀
뺴V		뺷
뺴W		뻍
뺴X		뻆
뺴Z		뻋
뺴a		뻉
뺴q		뻇
뺴s		뺸
뺴w		뺼
뺴x		뺵
뺴z		뻄
뻐!		뻒
뻐"		뻙
뻐#		뻦
뻐$		뻞
뻐%		뻝
뻐1		뻫
뻐2		뻤
뻐3		뻡
뻐A		뻗
뻐C		뻨
뻐D		뻛
뻐E		뻕
뻐F		뻚
뻐Q		뻪
뻐R		뻟
뻐S		뻖
뻐T		뻜
뻐V		뻓
뻐W		뻩
뻐X		뻢
뻐Z		뻧
뻐a		뻥
뻐q		뻣
뻐s		뻔
뻐w		뻘
뻐x		뻑
뻐z		뻠
뻬!		뻮
뻬"		뻵
뻬#		뼂
뻬$		뻺
뻬%		뻹
뻬1		뼇
뻬2		뼀
뻬3		뻽
뻬A		뻳
뻬C		뼄
뻬D		뻷
뻬E		뻱
뻬F		뻶
뻬Q		뼆
뻬R		뻻
뻬S		뻲
뻬T		뻸
뻬V		뻯
뻬W		뼅
뻬X		뻾
뻬Z		뼃
뻬a		뼁
뻬q		뻿
뻬s		뻰
뻬w		뻴
뻬x		뻭
뻬z		뻼
뼈!		뼊
뼈"		뼑
뼈#		뼞
뼈$		뼖
뼈%		뼕
뼈1		뼣
뼈2		뼜
뼈3		뼙
뼈A		뼏
뼈C		뼠
뼈D		뼓
뼈E		뼍
뼈F		뼒
뼈Q		뼢
뼈R		뼗
뼈S		뼎
뼈T		뼔
뼈V		뼋
뼈W		뼡
뼈X		뼚
뼈Z		뼟
뼈a		뼝
뼈q		뼛
뼈s		뼌
뼈w		뼐
뼈x		뼉
뼈z		뼘
뼤!		뼦
뼤"		뼭
뼤#		뼺
뼤$		뼲
뼤%		뼱
뼤1		뼿
뼤2		뼸
뼤3		뼵
뼤A		뼫
뼤C		뼼
뼤D		뼯
뼤E		뼩
뼤F		뼮
뼤Q		뼾
뼤R		뼳
뼤S		뼪
뼤T		뼰
뼤V		뼧
뼤W		뼽
뼤X		뼶
뼤Z		뼻
뼤a		뼹
뼤q		뼷
뼤s		뼨
뼤w		뼬
뼤x		뼥
뼤z		뼴
뽀!		뽂
뽀"		뽉
뽀#		뽖
뽀$		뽎
뽀%		뽍
뽀1		뽛
뽀2		뽔
뽀3		뽑
뽀A		뽇
뽀C		뽘
뽀D		뽋
뽀E		뽅
뽀F		뽊
뽀Q		뽚
뽀R		뽏
뽀S		뽆
뽀T		뽌
뽀V		뽃
뽀W		뽙
뽀X		뽒
뽀Z		뽗
뽀a		뽕
뽀d		뾔
뽀f		뽜
뽀q		뽓
뽀r		뽸
뽀s		뽄
뽀w		뽈
뽀x		뽁
뽀z		뽐
뽜!		뽞
뽜"		뽥
뽜#		뽲
뽜$		뽪
뽜%		뽩
뽜1		뽷
뽜2		뽰
뽜3		뽭
뽜A		뽣
뽜C		뽴
뽜D		뽧
뽜E		뽡
뽜F		뽦
뽜Q		뽶
뽜R		뽫
뽜S		뽢
뽜T		뽨
뽜V		뽟
뽜W		뽵
뽜X		뽮
뽜Z		뽳
뽜a		뽱
뽜q		뽯
뽜s		뽠
뽜w		뽤
뽜x		뽝
뽜z		뽬
뽸!		뽺
뽸"		뾁
뽸#		뾎
뽸$		뾆
뽸%		뾅
뽸1		뾓
뽸2		뾌
뽸3		뾉
뽸A		뽿
뽸C		뾐
뽸D		뾃
뽸E		뽽
뽸F		뾂
뽸Q		뾒
뽸R		뾇
뽸S		뽾
뽸T		뾄
뽸V		뽻
뽸W		뾑
뽸X		뾊
뽸Z		뾏
뽸a		뾍
뽸q		뾋
뽸s		뽼
뽸w		뾀
뽸x		뽹
뽸z		뾈
뾔!		뾖
뾔"		뾝
뾔#		뾪
뾔$		뾢
뾔%		뾡
뾔1		뾯
뾔2		뾨
뾔3		뾥
뾔A		뾛
뾔C		뾬
뾔D		뾟
뾔E		뾙
뾔F		뾞
뾔Q		뾮
뾔R		뾣
뾔S		뾚
뾔T		뾠
뾔V		뾗
뾔W		뾭
뾔X		뾦
뾔Z		뾫
뾔a		뾩
뾔q		뾧
뾔s		뾘
뾔w		뾜
뾔x		뾕
뾔z		뾤
뾰!		뾲
뾰"		뾹
뾰#		뿆
뾰$		뾾
뾰%		뾽
뾰1		뿋
뾰2		뿄
뾰3		뿁
뾰A		뾷
뾰C		뿈
뾰D		뾻
뾰E		뾵
뾰F		뾺
뾰Q		뿊
뾰R		뾿
뾰S		뾶
뾰T		뾼
뾰V		뾳
뾰W		뿉
뾰X		뿂
뾰Z		뿇
뾰a		뿅
뾰q		뿃
뾰s		뾴
뾰w		뾸
뾰x		뾱
뾰z		뿀
뿌!		뿎
뿌"		뿕
뿌#		뿢
뿌$		뿚
뿌%		뿙
뿌1		뿧
뿌2		뿠
뿌3		뿝
뿌A		뿓
뿌C		뿤
뿌D		뿗
뿌E		뿑
뿌F		뿖
뿌Q		뿦
뿌R		뿛
뿌S		뿒
뿌T		뿘
뿌V		뿏
뿌W		뿥
뿌X		뿞
뿌Z		뿣
뿌a		뿡
뿌c		쀄
뿌d		쀠
뿌q		뿟
뿌s		뿐
뿌t		뿨
뿌w		뿔
뿌x		뿍
뿌z		뿜
뿨!		뿪
뿨"		뿱
뿨#		뿾
뿨$		뿶
뿨%		뿵
뿨1		쀃
뿨2		뿼
뿨3		뿹
뿨A		뿯
뿨C		쀀
뿨D		뿳
뿨E		뿭
뿨F		뿲
뿨Q		쀂
뿨R		뿷
뿨S		뿮
뿨T		뿴
뿨V		뿫
뿨W		쀁
뿨X		뿺
뿨Z		뿿
뿨a		뿽
뿨q		뿻
뿨s		뿬
뿨w		뿰
뿨x		뿩
뿨z		뿸
쀄!		쀆
쀄"		쀍
쀄#		쀚
쀄$		쀒
쀄%		쀑
쀄1		쀟
쀄2		쀘
쀄3		쀕
쀄A		쀋
쀄C		쀜
쀄D		쀏
쀄E		쀉
쀄F		쀎
쀄Q		쀞
쀄R		쀓
쀄S		쀊
쀄T		쀐
쀄V		쀇
쀄W		쀝
쀄X		쀖
쀄Z		쀛
쀄a		쀙
쀄q		쀗
쀄s		쀈
쀄w		쀌
쀄x		쀅
쀄z		쀔
쀠!		쀢
쀠"		쀩
쀠#		쀶
쀠$		쀮
쀠%		쀭
쀠1		쀻
쀠2		쀴
쀠3		쀱
쀠A		쀧
쀠C		쀸
쀠D		쀫
쀠E		쀥
쀠F		쀪
쀠Q		쀺
쀠R		쀯
쀠S		쀦
쀠T		쀬
쀠V		쀣
쀠W		쀹
쀠X		쀲
쀠Z		쀷
쀠a		쀵
쀠q		쀳
쀠s		쀤
쀠w		쀨
쀠x		쀡
쀠z		쀰
쀼!		쀾
쀼"		쁅
쀼#		쁒
쀼$		쁊
쀼%		쁉
쀼1		쁗
쀼2		쁐
쀼3		쁍
쀼A		쁃
쀼C		쁔
쀼D		쁇
쀼E		쁁
쀼F		쁆
쀼Q		쁖
쀼R		쁋
쀼S		쁂
쀼T		쁈
쀼V		쀿
쀼W		쁕
쀼X		쁎
쀼Z		쁓
쀼a		쁑
쀼q		쁏
쀼s		쁀
쀼w		쁄
쀼x		쀽
쀼z		쁌
쁘!		쁚
쁘"		쁡
쁘#		쁮
쁘$		쁦
쁘%		쁥
쁘1		쁳
쁘2		쁬
쁘3		쁩
쁘A		쁟
쁘C		쁰
쁘D		쁣
쁘E		쁝
쁘F		쁢
쁘Q		쁲
쁘R		쁧
쁘S		쁞
쁘T		쁤
쁘V		쁛
쁘W		쁱
쁘X		쁪
쁘Z		쁯
쁘a		쁭
쁘q		쁫
쁘s		쁜
쁘w		쁠
쁘x		쁙
쁘z		쁨
쁴!		쁶
쁴"		쁽
쁴#		삊
쁴$		삂
쁴%		삁
쁴1		삏
쁴2		삈
쁴3		삅
쁴A		쁻
쁴C		삌
쁴D		쁿
쁴E		쁹
쁴F		쁾
쁴Q		삎
쁴R		삃
쁴S		쁺
쁴T		삀
쁴V		쁷
쁴W		삍
쁴X		삆
쁴Z		삋
쁴a		삉
쁴q		삇
쁴s		쁸
쁴w		쁼
쁴x		쁵
쁴z		삄
삐!		삒
삐"		삙
삐#		삦
삐$		삞
삐%		삝
삐1		삫
삐2		삤
삐3		삡
삐A		삗
삐C		삨
삐D		삛
삐E		삕
삐F		삚
삐Q		삪
삐R		삟
삐S		삖
삐T		삜
삐V		삓
삐W		삩
삐X		삢
삐Z		삧
삐a		삥
삐q		삣
삐s		삔
삐w		삘
삐x		삑
삐z		삠
사!		삮
사"		삵
사#		샂
사$		삺
사%		삹
사1		샇
사2		샀
사3		삽
사A		삳
사C		샄
사D		삷
사E		삱
사F		삶
사Q		샆
사R		삻
사S		삲
사T		삸
사V		삯
사W		샅
사X		삾
사Z		샃
사a		상
사q		삿
사s		산
사w		살
사x		삭
사z		삼
새!		샊
새"		샑
새#		샞
새$		샖
새%		샕
새1		샣
새2		샜
새3		샙
새A		샏
새C		샠
새D		샓
새E		샍
새F		샒
새Q		샢
새R		샗
새S		샎
새T		샔
새V		샋
새W		샡
새X		샚
새Z		샟
새a		생
새q		샛
새s		샌
새w		샐
새x		색
새z		샘
샤!		샦
샤"		샭
샤#		샺
샤$		샲
샤%		샱
샤1		샿
샤2		샸
샤3		샵
샤A		샫
샤C		샼
샤D		샯
샤E		샩
샤F		샮
샤Q		샾
샤R		샳
샤S		샪
샤T		샰
샤V		샧
샤W		샽
샤X		샶
샤Z		샻
샤a		샹
샤q		샷
샤s		샨
샤w		샬
샤x		샥
샤z		샴
섀!		섂
섀"		섉
섀#		섖
섀$		섎
섀%		섍
섀1		섛
섀2		섔
섀3		섑
섀A		섇
섀C		섘
섀D		섋
섀E		섅
섀F		섊
섀Q		섚
섀R		섏
섀S		섆
섀T		섌
섀V		섃
섀W		섙
섀X		섒
섀Z		섗
섀a		섕
섀q		섓
섀s		섄
섀w		섈
섀x		섁
섀z		섐
서!		섞
서"		섥
서#		섲
서$		섪
서%		섩
서1		섷
서2		섰
서3		섭
서A		섣
서C		섴
서D		섧
서E		섡
서F		섦
서Q		섶
서R		섫
서S		섢
서T		섨
서V		섟
서W		섵
서X		섮
서Z		섳
서a		성
서q		섯
서s		선
서w		설
서x		석
서z		섬
세!		섺
세"		셁
세#		셎
세$		셆
세%		셅
세1		셓
세2		셌
세3		셉
세A		섿
세C		셐
세D		셃
세E		섽
세F		셂
세Q		셒
세R		셇
세S		섾
세T		셄
세V		섻
세W		셑
세X		셊
세Z		셏
세a		셍
세q		셋
세s		센
세w		셀
세x		섹
세z		셈
셔!		셖
셔"		셝
셔#		셪
셔$		셢
셔%		셡
셔1		셯
셔2		셨
셔3		셥
셔A		셛
셔C		셬
셔D		셟
셔E		셙
셔F		셞
셔Q		셮
셔R		셣
셔S		셚
셔T		셠
셔V		셗
셔W		셭
셔X		셦
셔Z		셫
셔a		셩
셔q		셧
셔s		션
셔w		셜
셔x		셕
셔z		셤
셰!		셲
셰"		셹
셰#		솆
셰$		셾
셰%		셽
셰1		솋
셰2		솄
셰3		솁
셰A		셷
셰C		솈
셰D		셻
셰E		셵
셰F		셺
셰Q		솊
셰R		셿
셰S		셶
셰T		셼
셰V		셳
셰W		솉
셰X		솂
셰Z		솇
셰a		솅
셰q		솃
셰s		셴
셰w		셸
셰x		셱
셰z		솀
소!		솎
소"		솕
소#		솢
소$		솚
소%		솙
소1		솧
소2		솠
소3		솝
소A		솓
소C		솤
소D		솗
소E		솑
소F		솖
소Q		솦
소R		솛
소S		솒
소T		솘
소V		솏
소W		솥
소X		솞
소Z		솣
소a		송
소d		쇠
소f		솨
소q		솟
소r		쇄
소s		손
소w		솔
소x		속
소z		솜
솨!		솪
솨"		솱
솨#		솾
솨$		솶
솨%		솵
솨1		쇃
솨2		솼
솨3		솹
솨A		솯
솨C		쇀
솨D		솳
솨E		솭
솨F		솲
솨Q		쇂
솨R		솷
솨S		솮
솨T		솴
솨V		솫
솨W		쇁
솨X		솺
솨Z		솿
솨a		솽
솨q		솻
솨s		솬
솨w		솰
솨x		솩
솨z		솸
쇄!		쇆
쇄"		쇍
쇄#		쇚
쇄$		쇒
쇄%		쇑
쇄1		쇟
쇄2		쇘
쇄3		쇕
쇄A		쇋
쇄C		쇜
쇄D		쇏
쇄E		쇉
쇄F		쇎
쇄Q		쇞
쇄R		쇓
쇄S		쇊
쇄T		쇐
쇄V		쇇
쇄W		쇝
쇄X		쇖
쇄Z		쇛
쇄a		쇙
쇄q		쇗
쇄s		쇈
쇄w		쇌
쇄x		쇅
쇄z		쇔
쇠!		쇢
쇠"		쇩
쇠#		쇶
쇠$		쇮
쇠%		쇭
쇠1		쇻
쇠2		쇴
쇠3		쇱
쇠A		쇧
쇠C		쇸
쇠D		쇫
쇠E		쇥
쇠F		쇪
쇠Q		쇺
쇠R		쇯
쇠S		쇦
쇠T		쇬
쇠V		쇣
쇠W		쇹
쇠X		쇲
쇠Z		쇷
쇠a		쇵
쇠q		쇳
쇠s		쇤
쇠w		쇨
쇠x		쇡
쇠z		쇰
쇼!		쇾
쇼"		숅
쇼#		숒
쇼$		숊
쇼%		숉
쇼1		숗
쇼2		숐
쇼3		숍
쇼A		숃
쇼C		숔
쇼D		숇
쇼E		숁
쇼F		숆
쇼Q		숖
쇼R		숋
쇼S		숂
쇼T		숈
쇼V		쇿
쇼W		숕
쇼X		숎
쇼Z		숓
쇼a		숑
쇼q		숏
쇼s		숀
쇼w		숄
쇼x		쇽
쇼z		숌
수!		숚
수"		숡
수#		숮
수$		숦
수%		숥
수1		숳
수2		숬
수3		숩
수A		숟
수C		숰
수D		숣
수E		숝
수F		숢
수Q		숲
수R		숧
수S		숞
수T		숤
수V		숛
수W		숱
수X		숪
수Z		숯
수a		숭
수c		쉐
수d		쉬
수q		숫
수s		순
수t		숴
수w		술
수x		숙
수z		숨
숴!		숶
숴"		숽
숴#		쉊
숴$		쉂
숴%		쉁
숴1		쉏
숴2		쉈
숴3		쉅
숴A		숻
숴C		쉌
숴D		숿
숴E		숹
숴F		숾
숴Q		쉎
숴R		쉃
숴S		숺
숴T		쉀
숴V		숷
숴W		쉍
숴X		쉆
숴Z		쉋
숴a		쉉
숴q		쉇
숴s		숸
숴w		숼
숴x		숵
숴z		쉄
쉐!		쉒
쉐"		쉙
쉐#		쉦
쉐$		쉞
쉐%		쉝
쉐1		쉫
쉐2		쉤
쉐3		쉡
쉐A		쉗
쉐C		쉨
쉐D		쉛
쉐E		쉕
쉐F		쉚
쉐Q		쉪
쉐R		쉟
쉐S		쉖
쉐T		쉜
쉐V		쉓
쉐W		쉩
쉐X		쉢
쉐Z		쉧
쉐a		쉥
쉐q		쉣
쉐s		쉔
쉐w		쉘
쉐x		쉑
쉐z		쉠
쉬!		쉮
쉬"		쉵
쉬#		슂
쉬$		쉺
쉬%		쉹
쉬1		슇
쉬2		슀
쉬3		쉽
쉬A		쉳
쉬C		슄
쉬D		쉷
쉬E		쉱
쉬F		쉶
쉬Q		슆
쉬R		쉻
쉬S		쉲
쉬T		쉸
쉬V		쉯
쉬W		슅
쉬X		쉾
쉬Z		슃
쉬a		슁
쉬q		쉿
쉬s		쉰
쉬w		쉴
쉬x		쉭
쉬z		쉼
슈!		슊
슈"		슑
슈#		슞
슈$		슖
슈%		슕
슈1		슣
슈2		슜
슈3		슙
슈A		슏
슈C		슠
슈D		슓
슈E		슍
슈F		슒
슈Q		슢
슈R		슗
슈S		슎
슈T		슔
슈V		슋
슈W		슡
슈X		슚
슈Z		슟
슈a		슝
슈q		슛
슈s		슌
슈w		슐
슈x		슉
슈z		슘
스!		슦
스"		슭
스#		슺
스$		슲
스%		슱
스1		슿
스2		슸
스3		습
스A		슫
스C		슼
스D		슯
스E		슩
스F		슮
스Q		슾
스R		슳
스S		슪
스T		슰
스V		슧
스W		슽
스X		슶
스Z		슻
스a		승
스q		슷
스s		슨
스w		슬
스x		슥
스z		슴
싀!		싂
싀"		싉
싀#		싖
싀$		싎
싀%		싍
싀1		싛
싀2		싔
싀3		싑
싀A		싇
싀C		싘
싀D		싋
싀E		싅
싀F		싊
싀Q		싚
싀R		싏
싀S		싆
싀T		싌
싀V		싃
싀W		싙
싀X		싒
싀Z		싗
싀a		싕
싀q		싓
싀s		싄
싀w		싈
싀x		싁
싀z		싐
시!		싞
시"		싥
시#		싲
시$		싪
시%		싩
시1		싷
시2		싰
시3		십
시A		싣
시C		싴
시D		싧
시E		싡
시F		싦
시Q		싶
시R		싫
시S		싢
시T		싨
시V		싟
시W		싵
시X		싮
시Z		싳
시a		싱
시q		싯
시s		신
시w		실
시x		식
시z		심
싸!		싺
싸"		쌁
싸#		쌎
싸$		쌆
싸%		쌅
싸1		쌓
싸2		쌌
싸3		쌉
싸A		싿
싸C		쌐
싸D		쌃
싸E		싽
싸F		쌂
싸Q		쌒
싸R		쌇
싸S		싾
싸T		쌄
싸V		싻
싸W		쌑
싸X		쌊
싸Z		쌏
싸a		쌍
싸q		쌋
싸s		싼
싸w		쌀
싸x		싹
싸z		쌈
쌔!		쌖
쌔"		쌝
쌔#		쌪
쌔$		쌢
쌔%		쌡
쌔1		쌯
쌔2		쌨
쌔3		쌥
쌔A		쌛
쌔C		쌬
쌔D		쌟
쌔E		쌙
쌔F		쌞
쌔Q		쌮
쌔R		쌣
쌔S		쌚
쌔T		쌠
쌔V		쌗
쌔W		쌭
쌔X		쌦
쌔Z		쌫
쌔a		쌩
쌔q		쌧
쌔s		쌘
쌔w		쌜
쌔x		쌕
쌔z		쌤
쌰!		쌲
쌰"		쌹
쌰#		썆
쌰$		쌾
쌰%		쌽
쌰1		썋
쌰2		썄
쌰3		썁
쌰A		쌷
쌰C		썈
쌰D		쌻
쌰E		쌵
쌰F		쌺
쌰Q		썊
쌰R		쌿
쌰S		쌶
쌰T		쌼
쌰V		쌳
쌰W		썉
쌰X		썂
쌰Z		썇
쌰a		썅
쌰q		썃
쌰s		쌴
쌰w		쌸
쌰x		쌱
쌰z		썀
썌!		썎
썌"		썕
썌#		썢
썌$		썚
썌%		썙
썌1		썧
썌2		썠
썌3		썝
썌A		썓
썌C		썤
썌D		썗
썌E		썑
썌F		썖
썌Q		썦
썌R		썛
썌S		썒
썌T		썘
썌V		썏
썌W		썥
썌X		썞
썌Z		썣
썌a		썡
썌q		썟
썌s		썐
썌w		썔
썌x		썍
썌z		썜
써!		썪
써"		썱
써#		썾
써$		썶
써%		썵
써1		쎃
써2		썼
써3		썹
써A		썯
써C		쎀
써D		썳
써E		썭
써F		썲
써Q		쎂
써R		썷
써S		썮
써T		썴
써V		썫
써W		쎁
써X		썺
써Z		썿
써a		썽
써q		썻
써s		썬
써w		썰
써x		썩
써z		썸
쎄!		쎆
쎄"		쎍
쎄#		쎚
쎄$		쎒
쎄%		쎑
쎄1		쎟
쎄2		쎘
쎄3		쎕
쎄A		쎋
쎄C		쎜
쎄D		쎏
쎄E		쎉
쎄F		쎎
쎄Q		쎞
쎄R		쎓
쎄S		쎊
쎄T		쎐
쎄V		쎇
쎄W		쎝
쎄X		쎖
쎄Z		쎛
쎄a		쎙
쎄q		쎗
쎄s		쎈
쎄w		쎌
쎄x		쎅
쎄z		쎔
쎠!		쎢
쎠"		쎩
쎠#		쎶
쎠$		쎮
쎠%		쎭
쎠1		쎻
쎠2		쎴
쎠3		쎱
쎠A		쎧
쎠C		쎸
쎠D		쎫
쎠E		쎥
쎠F		쎪
쎠Q		쎺
쎠R		쎯
쎠S		쎦
쎠T		쎬
쎠V		쎣
쎠W		쎹
쎠X		쎲
쎠Z		쎷
쎠a		쎵
쎠q		쎳
쎠s		쎤
쎠w		쎨
쎠x		쎡
쎠z		쎰
쎼!		쎾
쎼"		쏅
쎼#		쏒
쎼$		쏊
쎼%		쏉
쎼1		쏗
쎼2		쏐
쎼3		쏍
쎼A		쏃
쎼C		쏔
쎼D		쏇
쎼E		쏁
쎼F		쏆
쎼Q		쏖
쎼R		쏋
쎼S		쏂
쎼T		쏈
쎼V		쎿
쎼W		쏕
쎼X		쏎
쎼Z		쏓
쎼a		쏑
쎼q		쏏
쎼s		쏀
쎼w		쏄
쎼x		쎽
쎼z		쏌
쏘!		쏚
쏘"		쏡
쏘#		쏮
쏘$		쏦
쏘%		쏥
쏘1		쏳
쏘2		쏬
쏘3		쏩
쏘A		쏟
쏘C		쏰
쏘D		쏣
쏘E		쏝
쏘F		쏢
쏘Q		쏲
쏘R		쏧
쏘S		쏞
쏘T		쏤
쏘V		쏛
쏘W		쏱
쏘X		쏪
쏘Z		쏯
쏘a		쏭
쏘d		쐬
쏘f		쏴
쏘q		쏫
쏘r		쐐
쏘s		쏜
쏘w		쏠
쏘x		쏙
쏘z		쏨
쏴!		쏶
쏴"		쏽
쏴#		쐊
쏴$		쐂
쏴%		쐁
쏴1		쐏
쏴2		쐈
쏴3		쐅
쏴A		쏻
쏴C		쐌
쏴D		쏿
쏴E		쏹
쏴F		쏾
쏴Q		쐎
쏴R		쐃
쏴S		쏺
쏴T		쐀
쏴V		쏷
쏴W		쐍
쏴X		쐆
쏴Z		쐋
쏴a		쐉
쏴q		쐇
쏴s		쏸
쏴w		쏼
쏴x		쏵
쏴z		쐄
쐐!		쐒
쐐"		쐙
쐐#		쐦
쐐$		쐞
쐐%		쐝
쐐1		쐫
쐐2		쐤
쐐3		쐡
쐐A		쐗
쐐C		쐨
쐐D		쐛
쐐E		쐕
쐐F		쐚
쐐Q		쐪
쐐R		쐟
쐐S		쐖
쐐T		쐜
쐐V		쐓
쐐W		쐩
쐐X		쐢
쐐Z		쐧
쐐a		쐥
쐐q		쐣
쐐s		쐔
쐐w		쐘
쐐x		쐑
쐐z		쐠
쐬!		쐮
쐬"		쐵
쐬#		쑂
쐬$		쐺
쐬%		쐹
쐬1		쑇
쐬2		쑀
쐬3		쐽
쐬A		쐳
쐬C		쑄
쐬D		쐷
쐬E		쐱
쐬F		쐶
쐬Q		쑆
쐬R		쐻
쐬S		쐲
쐬T		쐸
쐬V		쐯
쐬W		쑅
쐬X		쐾
쐬Z		쑃
쐬a		쑁
쐬q		쐿
쐬s		쐰
쐬w		쐴
쐬x		쐭
쐬z		쐼
쑈!		쑊
쑈"		쑑
쑈#		쑞
쑈$		쑖
쑈%		쑕
쑈1		쑣
쑈2		쑜
쑈3		쑙
쑈A		쑏
쑈C		쑠
쑈D		쑓
쑈E		쑍
쑈F		쑒
쑈Q		쑢
쑈R		쑗
쑈S		쑎
쑈T		쑔
쑈V		쑋
쑈W		쑡
쑈X		쑚
쑈Z		쑟
쑈a		쑝
쑈q		쑛
쑈s		쑌
쑈w		쑐
쑈x		쑉
쑈z		쑘
쑤!		쑦
쑤"		쑭
쑤#		쑺
쑤$		쑲
쑤%		쑱
쑤1		쑿
쑤2		쑸
쑤3		쑵
쑤A		쑫
쑤C		쑼
쑤D		쑯
쑤E		쑩
쑤F		쑮
쑤Q		쑾
쑤R		쑳
쑤S		쑪
쑤T		쑰
쑤V		쑧
쑤W		쑽
쑤X		쑶
쑤Z		쑻
쑤a		쑹
쑤c		쒜
쑤d		쒸
쑤q		쑷
쑤s		쑨
쑤t		쒀
쑤w		쑬
쑤x		쑥
쑤z		쑴
쒀!		쒂
쒀"		쒉
쒀#		쒖
쒀$		쒎
쒀%		쒍
쒀1		쒛
쒀2		쒔
쒀3		쒑
쒀A		쒇
쒀C		쒘
쒀D		쒋
쒀E		쒅
쒀F		쒊
쒀Q		쒚
쒀R		쒏
쒀S		쒆
쒀T		쒌
쒀V		쒃
쒀W		쒙
쒀X		쒒
쒀Z		쒗
쒀a		쒕
쒀q		쒓
쒀s		쒄
쒀w		쒈
쒀x		쒁
쒀z		쒐
쒜!		쒞
쒜"		쒥
쒜#		쒲
쒜$		쒪
쒜%		쒩
쒜1		쒷
쒜2		쒰
쒜3		쒭
쒜A		쒣
쒜C		쒴
쒜D		쒧
쒜E		쒡
쒜F		쒦
쒜Q		쒶
쒜R		쒫
쒜S		쒢
쒜T		쒨
쒜V		쒟
쒜W		쒵
쒜X		쒮
쒜Z		쒳
쒜a		쒱
쒜q		쒯
쒜s		쒠
쒜w		쒤
쒜x		쒝
쒜z		쒬
쒸!		쒺
쒸"		쓁
쒸#		쓎
쒸$		쓆
쒸%		쓅
쒸1		쓓
쒸2		쓌
쒸3		쓉
쒸A		쒿
쒸C		쓐
쒸D		쓃
쒸E		쒽
쒸F		쓂
쒸Q		쓒
쒸R		쓇
쒸S		쒾
쒸T		쓄
쒸V		쒻
쒸W		쓑
쒸X		쓊
쒸Z		쓏
쒸a		쓍
쒸q		쓋
쒸s		쒼
쒸w		쓀
쒸x		쒹
쒸z		쓈
쓔!		쓖
쓔"		쓝
쓔#		쓪
쓔$		쓢
쓔%		쓡
쓔1		쓯
쓔2		쓨
쓔3		쓥
쓔A		쓛
쓔C		쓬
쓔D		쓟
쓔E		쓙
쓔F		쓞
쓔Q		쓮
쓔R		쓣
쓔S		쓚
쓔T		쓠
쓔V		쓗
쓔W		쓭
쓔X		쓦
쓔Z		쓫
쓔a		쓩
쓔q		쓧
쓔s		쓘
쓔w		쓜
쓔x		쓕
쓔z		쓤
쓰!		쓲
쓰"		쓹
쓰#		씆
쓰$		쓾
쓰%		쓽
쓰1		씋
쓰2		씄
쓰3		씁
쓰A		쓷
쓰C		씈
쓰D		쓻
쓰E		쓵
쓰F		쓺
쓰Q		씊
쓰R		쓿
쓰S		쓶
쓰T		쓼
쓰V		쓳
쓰W		씉
쓰X		씂
쓰Z		씇
쓰a		씅
쓰q		씃
쓰s		쓴
쓰w		쓸
쓰x		쓱
쓰z		씀
씌!		씎
씌"		씕
씌#		씢
씌$		씚
씌%		씙
씌1		씧
씌2		씠
씌3		씝
씌A		씓
씌C		씤
씌D		씗
씌E		씑
씌F		씖
씌Q		씦
씌R		씛
씌S		씒
씌T		씘
씌V		씏
씌W		씥
씌X		씞
씌Z		씣
씌a		씡
씌q		씟
씌s		씐
씌w		씔
씌x		씍
씌z		씜
씨!		씪
씨"		씱
씨#		씾
씨$		씶
씨%		씵
씨1		앃
씨2		씼
씨3		씹
씨A		씯
씨C		앀
씨D		씳
씨E		씭
씨F		씲
씨Q		앂
씨R		씷
씨S		씮
씨T		씴
씨V		씫
씨W		앁
씨X		씺
씨Z		씿
씨a		씽
씨q		씻
씨s		씬
씨w		씰
씨x		씩
씨z		씸
아!		앆
아"		앍
아#		앚
아$		앒
아%		앑
아1		앟
아2		았
아3		압
아A		앋
아C		앜
아D		앏
아E		앉
아F		앎
아Q		앞
아R		앓
아S		않
아T		앐
아V		앇
아W		앝
아X		앖
아Z		앛
아a		앙
아q		앗
아s		안
아w		알
아x		악
아z		암
애!		앢
애"		앩
애#		앶
애$		앮
애%		앭
애1		앻
애2		앴
애3		앱
애A		앧
애C		앸
애D		앫
애E		앥
애F		앪
애Q		앺
애R		앯
애S		앦
애T		앬
애V		앣
애W		앹
애X		앲
애Z		앷
애a		앵
애q		앳
애s		앤
애w		앨
애x		액
애z		앰
야!		앾
야"		얅
야#		얒
야$		얊
야%		얉
야1		얗
야2		얐
야3		얍
야A		얃
야C		얔
야D		얇
야E		얁
야F		얆
야Q		얖
야R		얋
야S		얂
야T		얈
야V		앿
야W		얕
야X		얎
야Z		얓
야a		양
야q		얏
야s		얀
야w		얄
야x		약
야z		얌
얘!		얚
얘"		얡
얘#		얮
얘$		얦
얘%		얥
얘1		얳
얘2		얬
얘3		얩
얘A		얟
얘C		얰
얘D		얣
얘E		얝
얘F		얢
얘Q		얲
얘R		얧
얘S		얞
얘T		얤
얘V		얛
얘W		얱
얘X		얪
얘Z		얯
얘a		얭
얘q		얫
얘s		얜
얘w		얠
얘x		얙
얘z		얨
어!		얶
어"		얽
어#		엊
어$		엂
어%		엁
어1		엏
어2		었
어3		업
어A		얻
어C		엌
어D		얿
어E		얹
어F		얾
어Q		엎
어R		엃
어S		얺
어T		엀
어V		얷
어W		엍
어X		없
어Z		엋
어a		엉
어q		엇
어s		언
어w		얼
어x		억
어z		엄
에!		엒
에"		엙
에#		엦
에$		엞
에%		엝
에1		엫
에2		엤
에3		엡
에A		엗
에C		엨
에D		엛
에E		엕
에F		엚
에Q		엪
에R		엟
에S		엖
에T		엜
에V		엓
에W		엩
에X		엢
에Z		엧
에a		엥
에q		엣
에s		엔
에w		엘
에x		엑
에z		엠
여!		엮
여"		엵
여#		옂
여$		엺
여%		엹
여1		옇
여2		였
여3		엽
여A		엳
여C		옄
여D		엷
여E		엱
여F		엶
여Q		옆
여R		엻
여S		엲
여T		엸
여V		엯
여W		옅
여X		엾
여Z		옃
여a		영
여q		엿
여s		연
여w		열
여x		역
여z		염
예!		옊
예"		옑
예#		옞
예$		옖
예%		옕
예1		옣
예2		옜
예3		옙
예A		옏
예C		옠
예D		옓
예E		옍
예F		옒
예Q		옢
예R		옗
예S		옎
예T		옔
예V		옋
예W		옡
예X		옚
예Z		옟
예a		옝
예q		옛
예s		옌
예w		옐
예x		옉
예z		옘
오!		옦
오"		옭
오#		옺
오$		옲
오%		옱
오1		옿
오2		옸
오3		옵
오A		옫
오C		옼
오D		옯
오E		옩
오F		옮
오Q		옾
오R		옳
오S		옪
오T		옰
오V		옧
오W		옽
오X		옶
오Z		옻
오a		옹
오d		외
오f		와
오q		옷
오r		왜
오s		온
오w		올
오x		옥
오z		옴
와!		왂
와"		왉
와#		왖
와$		왎
와%		왍
와1		왛
와2		왔
와3		왑
와A		왇
와C		왘
와D		왋
와E		왅
와F		왊
와Q		왚
와R		왏
와S		왆
와T		왌
와V		왃
와W		왙
와X		왒
와Z		왗
와a		왕
와q		왓
와s		완
와w		왈
와x		왁
와z		왐
왜!		왞
왜"		왥
왜#		왲
왜$		왪
왜%		왩
왜1		왷
왜2		왰
왜3		왭
왜A		왣
왜C		왴
왜D		왧
왜E		왡
왜F		왦
왜Q		왶
왜R		왫
왜S		왢
왜T		왨
왜V		왟
왜W		왵
왜X		왮
왜Z		왳
왜a		왱
왜q		왯
왜s		왠
왜w		왤
왜x		왝
왜z		왬
외!		왺
외"		욁
외#		욎
외$		욆
외%		욅
외1		욓
외2		욌
외3		욉
외A		왿
외C		욐
외D		욃
외E		왽
외F		욂
외Q		욒
외R		욇
외S		왾
외T		욄
외V		왻
외W		욑
외X		욊
외Z		욏
외a		욍
외q		욋
외s		왼
외w		욀
외x		왹
외z		욈
요!		욖
요"		욝
요#		욪
요$		욢
요%		욡
요1		욯
요2		욨
요3		욥
요A		욛
요C		욬
요D		욟
요E		욙
요F		욞
요Q		욮
요R		욣
요S		욚
요T		욠
요V		욗
요W		욭
요X		욦
요Z		욫
요a		용
요q		욧
요s		욘
요w		욜
요x		욕
요z		욤
우!		욲
우"		욹
우#		웆
우$		욾
우%		욽
우1		웋
우2		웄
우3		웁
우A		욷
우C		웈
우D		욻
우E		욵
우F		욺
우Q		웊
우R		욿
우S		욶
우T		욼
우V		욳
우W		웉
우X		웂
우Z		웇
우a		웅
우c		웨
우d		위
우q		웃
우s		운
우t		워
우w		울
우x		욱
우z		움
워!		웎
워"		웕
워#		웢
워$		웚
워%		웙
워1		웧
워2		웠
워3		웝
워A		웓
워C		웤
워D		웗
워E		웑
워F		웖
워Q		웦
워R		웛
워S		웒
워T		웘
워V		웏
워W		웥
워X		웞
워Z		웣
워a		웡
워q		웟
워s		원
워w		월
워x		웍
워z		웜
웨!		웪
웨"		웱
웨#		웾
웨$		웶
웨%		웵
웨1		윃
웨2		웼
웨3		웹
웨A		웯
웨C		윀
웨D		웳
웨E		웭
웨F		웲
웨Q		윂
웨R		웷
웨S		웮
웨T		웴
웨V		웫
웨W		윁
웨X		웺
웨Z		웿
웨a		웽
웨q		웻
웨s		웬
웨w		웰
웨x		웩
웨z		웸
위!		윆
위"		윍
위#		윚
위$		윒
위%		윑
위1		윟
위2		윘
위3		윕
위A		윋
위C		윜
위D		윏
위E		윉
위F		윎
위Q		윞
위R		윓
위S		윊
위T		윐
위V		윇
위W		윝
위X		윖
위Z		윛
위a		윙
위q		윗
위s		윈
위w		윌
위x		윅
위z		윔
유!		윢
유"		윩
유#		윶
유$		윮
유%		윭
유1		윻
유2		윴
유3		윱
유A		윧
유C		윸
유D		윫
유E		윥
유F		윪
유Q		윺
유R		윯
유S		윦
유T		윬
유V		윣
유W		윹
유X		윲
유Z		윷
유a		융
유q		윳
유s		윤
유w		율
유x		육
유z		윰
으!		윾
으"		읅
으#		읒
으$		읊
으%		읉
으1		읗
으2		읐
으3		읍
으A		읃
으C		읔
으D		읇
으E		읁
으F		읆
으Q		읖
으R		읋
으S		읂
으T		읈
으V		윿
으W		읕
으X		읎
으Z		읓
으a		응
으q		읏
으s		은
으w		을
으x		윽
으z		음
의!		읚
의"		읡
의#		읮
의$		읦
의%		읥
의1		읳
의2		읬
의3		읩
의A		읟
의C		읰
의D		읣
의E		읝
의F		읢
의Q		읲
의R		읧
의S		읞
의T		읤
의V		읛
의W		읱
의X		읪
의Z		읯
의a		읭
의q		읫
의s		읜
의w		읠
의x		읙
의z		읨
이!		읶
이"		읽
이#		잊
이$		잂
이%		잁
이1		잏
이2		있
이3		입
이A		읻
이C		잌
이D		읿
이E		읹
이F		읾
이Q		잎
이R		잃
이S		읺
이T		잀
이V		읷
이W		잍
이X		잆
이Z		잋
이a		잉
이q		잇
이s		인
이w		일
이x		익
이z		임
자!		잒
자"		잙
자#		잦
자$		잞
자%		잝
자1		잫
자2		잤
자3		잡
자A		잗
자C		잨
자D		잛
자E		잕
자F		잚
자Q		잪
자R		잟
자S		잖
자T		잜
자V		잓
자W		잩
자X		잢
자Z		잧
자a		장
자q		잣
자s		잔
자w		잘
자x		작
자z		잠
재!		잮
재"		잵
재#		쟂
재$		잺
재%		잹
재1		쟇
재2		쟀
재3		잽
재A		잳
재C		쟄
재D		잷
재E		잱
재F		잶
재Q		쟆
재R		잻
재S		잲
재T		잸
재V		잯
재W		쟅
재X		잾
재Z		쟃
재a		쟁
재q		잿
재s		잰
재w		잴
재x		잭
재z		잼
쟈!		쟊
쟈"		쟑
쟈#		쟞
쟈$		쟖
쟈%		쟕
쟈1		쟣
쟈2		쟜
쟈3		쟙
쟈A		쟏
쟈C		쟠
쟈D		쟓
쟈E		쟍
쟈F		쟒
쟈Q		쟢
쟈R		쟗
쟈S		쟎
쟈T		쟔
쟈V		쟋
쟈W		쟡
쟈X		쟚
쟈Z		쟟
쟈a		쟝
쟈q		쟛
쟈s		쟌
쟈w		쟐
쟈x		쟉
쟈z		쟘
쟤!		쟦
쟤"		쟭
쟤#		쟺
쟤$		쟲
쟤%		쟱
쟤1		쟿
쟤2		쟸
쟤3		쟵
쟤A		쟫
쟤C		쟼
쟤D		쟯
쟤E		쟩
쟤F		쟮
쟤Q		쟾
쟤R		쟳
쟤S		쟪
쟤T		쟰
쟤V		쟧
쟤W		쟽
쟤X		쟶
쟤Z		쟻
쟤a		쟹
쟤q		쟷
쟤s		쟨
쟤w		쟬
쟤x		쟥
쟤z		쟴
저!		젂
저"		젉
저#		젖
저$		젎
저%		젍
저1		젛
저2		젔
저3		접
저A		젇
저C		젘
저D		젋
저E		젅
저F		젊
저Q		젚
저R		젏
저S		젆
저T		젌
저V		젃
저W		젙
저X		젒
저Z		젗
저a		정
저q		젓
저s		전
저w		절
저x		적
저z		점
제!		젞
제"		젥
제#		젲
제$		젪
제%		젩
제1		젷
제2		젰
제3		젭
제A		젣
제C		젴
제D		젧
제E		젡
제F		젦
제Q		젶
제R		젫
제S		젢
제T		젨
제V		젟
제W		젵
제X		젮
제Z		젳
제a		젱
제q		젯
제s		젠
제w		젤
제x		젝
제z		젬
져!		젺
져"		졁
져#		졎
져$		졆
져%		졅
져1		졓
져2		졌
져3		졉
져A		젿
져C		졐
져D		졃
져E		젽
져F		졂
져Q		졒
져R		졇
져S		젾
져T		졄
져V		젻
져W		졑
져X		졊
져Z		졏
져a		졍
져q		졋
져s		젼
져w		졀
져x		젹
져z		졈
졔!		졖
졔"		졝
졔#		졪
졔$		졢
졔%		졡
졔1		졯
졔2		졨
졔3		졥
졔A		졛
졔C		졬
졔D		졟
졔E		졙
졔F		졞
졔Q		졮
졔R		졣
졔S		졚
졔T		졠
졔V		졗
졔W		졭
졔X		졦
졔Z		졫
졔a		졩
졔q		졧
졔s		졘
졔w		졜
졔x		졕
졔z		졤
조!		졲
조"		졹
조#		좆
조$		졾
조%		졽
조1		좋
조2		좄
조3		좁
조A		졷
조C		좈
조D		졻
조E		졵
조F		졺
조Q		좊
조R		졿
조S		졶
조T		졼
조V		졳
조W		좉
조X		좂
조Z		좇
조a		종
조d		죄
조f		좌
조q		좃
조r		좨
조s		존
조w		졸
조x		족
조z		좀
좌!		좎
좌"		좕
좌#		좢
좌$		좚
좌%		좙
좌1		좧
좌2		좠
좌3		좝
좌A		좓
좌C		좤
좌D		좗
좌E		좑
좌F		좖
좌Q		좦
좌R		좛
좌S		좒
좌T		좘
좌V		좏
좌W		좥
좌X		좞
좌Z		좣
좌a		좡
좌q		좟
좌s		좐
좌w		좔
좌x		좍
좌z		좜
좨!		좪
좨"		좱
좨#		좾
좨$		좶
좨%		좵
좨1		죃
좨2		좼
좨3		좹
좨A		좯
좨C		죀
좨D		좳
좨E		좭
좨F		좲
좨Q		죂
좨R		좷
좨S		좮
좨T		좴
좨V		좫
좨W		죁
좨X		좺
좨Z		좿
좨a		좽
좨q		좻
좨s		좬
좨w		좰
좨x		좩
좨z		좸
죄!		죆
죄"		죍
죄#		죚
죄$		죒
죄%		죑
죄1		죟
죄2		죘
죄3		죕
죄A		죋
죄C		죜
죄D		죏
죄E		죉
죄F		죎
죄Q		죞
죄R		죓
죄S		죊
죄T		죐
죄V		죇
죄W		죝
죄X		죖
죄Z		죛
죄a		죙
죄q		죗
죄s		죈
죄w		죌
죄x		죅
죄z		죔
죠!		죢
죠"		죩
죠#		죶
죠$		죮
죠%		죭
죠1		죻
죠2		죴
죠3		죱
죠A		죧
죠C		죸
죠D		죫
죠E		죥
죠F		죪
죠Q		죺
죠R		죯
죠S		죦
죠T		죬
죠V		죣
죠W		죹
죠X		죲
죠Z		죷
죠a		죵
죠q		죳
죠s		죤
죠w		죨
죠x		죡
죠z		죰
주!		죾
주"		줅
주#		줒
주$		줊
주%		줉
주1		줗
주2		줐
주3		줍
주A		줃
주C		줔
주D		줇
주E		줁
주F		줆
주Q		줖
주R		줋
주S		줂
주T		줈
주V		죿
주W		줕
주X		줎
주Z		줓
주a		중
주c		줴
주d		쥐
주q		줏
주s		준
주t		줘
주w		줄
주x		죽
주z		줌
줘!		줚
줘"		줡
줘#		줮
줘$		줦
줘%		줥
줘1		줳
줘2		줬
줘3		줩
줘A		줟
줘C		줰
줘D		줣
줘E		줝
줘F		줢
줘Q		줲
줘R		줧
줘S		줞
줘T		줤
줘V		줛
줘W		줱
줘X		줪
줘Z		줯
줘a		줭
줘q		줫
줘s		줜
줘w		줠
줘x		줙
줘z		줨
줴!		줶
줴"		줽
줴#		쥊
줴$		쥂
줴%		쥁
줴1		쥏
줴2		쥈
줴3		쥅
줴A		줻
줴C		쥌
줴D		줿
줴E		줹
줴F		줾
줴Q		쥎
줴R		쥃
줴S		줺
줴T		쥀
줴V		줷
줴W		쥍
줴X		쥆
줴Z		쥋
줴a		쥉
줴q		쥇
줴s		줸
줴w		줼
줴x		줵
줴z		쥄
쥐!		쥒
쥐"		쥙
쥐#		쥦
쥐$		쥞
쥐%		쥝
쥐1		쥫
쥐2		쥤
쥐3		쥡
쥐A		쥗
쥐C		쥨
쥐D		쥛
쥐E		쥕
쥐F		쥚
쥐Q		쥪
쥐R		쥟
쥐S		쥖
쥐T		쥜
쥐V		쥓
쥐W		쥩
쥐X		쥢
쥐Z		쥧
쥐a		쥥
쥐q		쥣
쥐s		쥔
쥐w		쥘
쥐x		쥑
쥐z		쥠
쥬!		쥮
쥬"		쥵
쥬#		즂
쥬$		쥺
쥬%		쥹
쥬1		즇
쥬2		즀
쥬3		쥽
쥬A		쥳
쥬C		즄
쥬D		쥷
쥬E		쥱
쥬F		쥶
쥬Q		즆
쥬R		쥻
쥬S		쥲
쥬T		쥸
쥬V		쥯
쥬W		즅
쥬X		쥾
쥬Z		즃
쥬a		즁
쥬q		쥿
쥬s		쥰
쥬w		쥴
쥬x		쥭
쥬z		쥼
즈!		즊
즈"		즑
즈#		즞
즈$		즖
즈%		즕
즈1		즣
즈2		즜
즈3		즙
즈A		즏
즈C		즠
즈D		즓
즈E		즍
즈F		즒
즈Q		즢
즈R		즗
즈S		즎
즈T		즔
즈V		즋
즈W		즡
즈X		즚
즈Z		즟
즈a		증
즈q		즛
즈s		즌
즈w		즐
즈x		즉
즈z		즘
즤!		즦
즤"		즭
즤#		즺
즤$		즲
즤%		즱
즤1		즿
즤2		즸
즤3		즵
즤A		즫
즤C		즼
즤D		즯
즤E		즩
즤F		즮
즤Q		즾
즤R		즳
즤S		즪
즤T		즰
즤V		즧
즤W		즽
즤X		즶
즤Z		즻
즤a		즹
즤q		즷
즤s		즨
즤w		즬
즤x		즥
즤z		즴
지!		짂
지"		짉
지#		짖
지$		짎
지%		짍
지1		짛
지2		짔
지3		집
지A		짇
지C		짘
지D		짋
지E		짅
지F		짊
지Q		짚
지R		짏
지S		짆
지T		짌
지V		짃
지W		짙
지X		짒
지Z		짗
지a		징
지q		짓
지s		진
지w		질
지x		직
지z		짐
짜!		짞
짜"		짥
짜#		짲
짜$		짪
짜%		짩
짜1		짷
짜2		짰
짜3		짭
짜A		짣
짜C		짴
짜D		짧
짜E		짡
짜F		짦
짜Q		짶
짜R		짫
짜S		짢
짜T		짨
짜V		짟
짜W		짵
짜X		짮
짜Z		짳
짜a		짱
짜q		짯
짜s		짠
짜w		짤
짜x		짝
짜z		짬
째!		짺
째"		쨁
째#		쨎
째$		쨆
째%		쨅
째1		쨓
째2		쨌
째3		쨉
째A		짿
째C		쨐
째D		쨃
째E		짽
째F		쨂
째Q		쨒
째R		쨇
째S		짾
째T		쨄
째V		짻
째W		쨑
째X		쨊
째Z		쨏
째a		쨍
째q		쨋
째s		짼
째w		쨀
째x		짹
째z		쨈
쨔!		쨖
쨔"		쨝
쨔#		쨪
쨔$		쨢
쨔%		쨡
쨔1		쨯
쨔2		쨨
쨔3		쨥
쨔A		쨛
쨔C		쨬
쨔D		쨟
쨔E		쨙
쨔F		쨞
쨔Q		쨮
쨔R		쨣
쨔S		쨚
쨔T		쨠
쨔V		쨗
쨔W		쨭
쨔X		쨦
쨔Z		쨫
쨔a		쨩
쨔q		쨧
쨔s		쨘
쨔w		쨜
쨔x		쨕
쨔z		쨤
쨰!		쨲
쨰"		쨹
쨰#		쩆
쨰$		쨾
쨰%		쨽
쨰1		쩋
쨰2		쩄
쨰3		쩁
쨰A		쨷
쨰C		쩈
쨰D		쨻
쨰E		쨵
쨰F		쨺
쨰Q		쩊
쨰R		쨿
쨰S		쨶
쨰T		쨼
쨰V		쨳
쨰W		쩉
쨰X		쩂
쨰Z		쩇
쨰a		쩅
쨰q		쩃
쨰s		쨴
쨰w		쨸
쨰x		쨱
쨰z		쩀
쩌!		쩎
쩌"		쩕
쩌#		쩢
쩌$		쩚
쩌%		쩙
쩌1		쩧
쩌2		쩠
쩌3		쩝
쩌A		쩓
쩌C		쩤
쩌D		쩗
쩌E		쩑
쩌F		쩖
쩌Q		쩦
쩌R		쩛
쩌S		쩒
쩌T		쩘
쩌V		쩏
쩌W		쩥
쩌X		쩞
쩌Z		쩣
쩌a		쩡
쩌q		쩟
쩌s		쩐
쩌w		쩔
쩌x		쩍
쩌z		쩜
쩨!		쩪
쩨"		쩱
쩨#		쩾
쩨$		쩶
쩨%		쩵
쩨1		쪃
쩨2		쩼
쩨3		쩹
쩨A		쩯
쩨C		쪀
쩨D		쩳
쩨E		쩭
쩨F		쩲
쩨Q		쪂
쩨R		쩷
쩨S		쩮
쩨T		쩴
쩨V		쩫
쩨W		쪁
쩨X		쩺
쩨Z		쩿
쩨a		쩽
쩨q		쩻
쩨s		쩬
쩨w		쩰
쩨x		쩩
쩨z		쩸
쪄!		쪆
쪄"		쪍
쪄#		쪚
쪄$		쪒
쪄%		쪑
쪄1		쪟
쪄2		쪘
쪄3		쪕
쪄A		쪋
쪄C		쪜
쪄D		쪏
쪄E		쪉
쪄F		쪎
쪄Q		쪞
쪄R		쪓
쪄S		쪊
쪄T		쪐
쪄V		쪇
쪄W		쪝
쪄X		쪖
쪄Z		쪛
쪄a		쪙
쪄q		쪗
쪄s		쪈
쪄w		쪌
쪄x		쪅
쪄z		쪔
쪠!		쪢
쪠"		쪩
쪠#		쪶
쪠$		쪮
쪠%		쪭
쪠1		쪻
쪠2		쪴
쪠3		쪱
쪠A		쪧
쪠C		쪸
쪠D		쪫
쪠E		쪥
쪠F		쪪
쪠Q		쪺
쪠R		쪯
쪠S		쪦
쪠T		쪬
쪠V		쪣
쪠W		쪹
쪠X		쪲
쪠Z		쪷
쪠a		쪵
쪠q		쪳
쪠s		쪤
쪠w		쪨
쪠x		쪡
쪠z		쪰
쪼!		쪾
쪼"		쫅
쪼#		쫒
쪼$		쫊
쪼%		쫉
쪼1		쫗
쪼2		쫐
쪼3		쫍
쪼A		쫃
쪼C		쫔
쪼D		쫇
쪼E		쫁
쪼F		쫆
쪼Q		쫖
쪼R		쫋
쪼S		쫂
쪼T		쫈
쪼V		쪿
쪼W		쫕
쪼X		쫎
쪼Z		쫓
쪼a		쫑
쪼d		쬐
쪼f		쫘
쪼q		쫏
쪼r		쫴
쪼s		쫀
쪼w		쫄
쪼x		쪽
쪼z		쫌
쫘!		쫚
쫘"		쫡
쫘#		쫮
쫘$		쫦
쫘%		쫥
쫘1		쫳
쫘2		쫬
쫘3		쫩
쫘A		쫟
쫘C		쫰
쫘D		쫣
쫘E		쫝
쫘F		쫢
쫘Q		쫲
쫘R		쫧
쫘S		쫞
쫘T		쫤
쫘V		쫛
쫘W		쫱
쫘X		쫪
쫘Z		쫯
쫘a		쫭
쫘q		쫫
쫘s		쫜
쫘w		쫠
쫘x		쫙
쫘z		쫨
쫴!		쫶
쫴"		쫽
쫴#		쬊
쫴$		쬂
쫴%		쬁
쫴1		쬏
쫴2		쬈
쫴3		쬅
쫴A		쫻
쫴C		쬌
쫴D		쫿
쫴E		쫹
쫴F		쫾
쫴Q		쬎
쫴R		쬃
쫴S		쫺
쫴T		쬀
쫴V		쫷
쫴W		쬍
쫴X		쬆
쫴Z		쬋
쫴a		쬉
쫴q		쬇
쫴s		쫸
쫴w		쫼
쫴x		쫵
쫴z		쬄
쬐!		쬒
쬐"		쬙
쬐#		쬦
쬐$		쬞
쬐%		쬝
쬐1		쬫
쬐2		쬤
쬐3		쬡
쬐A		쬗
쬐C		쬨
쬐D		쬛
쬐E		쬕
쬐F		쬚
쬐Q		쬪
쬐R		쬟
쬐S		쬖
쬐T		쬜
쬐V		쬓
쬐W		쬩
쬐X		쬢
쬐Z		쬧
쬐a		쬥
쬐q		쬣
쬐s		쬔
쬐w		쬘
쬐x		쬑
쬐z		쬠
쬬!		쬮
쬬"		쬵
쬬#		쭂
쬬$		쬺
쬬%		쬹
쬬1		쭇
쬬2		쭀
쬬3		쬽
쬬A		쬳
쬬C		쭄
쬬D		쬷
쬬E		쬱
쬬F		쬶
쬬Q		쭆
쬬R		쬻
쬬S		쬲
쬬T		쬸
쬬V		쬯
쬬W		쭅
쬬X		쬾
쬬Z		쭃
쬬a		쭁
쬬q		쬿
쬬s		쬰
쬬w		쬴
쬬x		쬭
쬬z		쬼
쭈!		쭊
쭈"		쭑
쭈#		쭞
쭈$		쭖
쭈%		쭕
쭈1		쭣
쭈2		쭜
쭈3		쭙
쭈A		쭏
쭈C		쭠
쭈D		쭓
쭈E		쭍
쭈F		쭒
쭈Q		쭢
쭈R		쭗
쭈S		쭎
쭈T		쭔
쭈V		쭋
쭈W		쭡
쭈X		쭚
쭈Z		쭟
쭈a		쭝
쭈c		쮀
쭈d		쮜
쭈q		쭛
쭈s		쭌
쭈t		쭤
쭈w		쭐
쭈x		쭉
쭈z		쭘
쭤!		쭦
쭤"		쭭
쭤#		쭺
쭤$		쭲
쭤%		쭱
쭤1		쭿
쭤2		쭸
쭤3		쭵
쭤A		쭫
쭤C		쭼
쭤D		쭯
쭤E		쭩
쭤F		쭮
쭤Q		쭾
쭤R		쭳
쭤S		쭪
쭤T		쭰
쭤V		쭧
쭤W		쭽
쭤X		쭶
쭤Z		쭻
쭤a		쭹
쭤q		쭷
쭤s		쭨
쭤w		쭬
쭤x		쭥
쭤z		쭴
쮀!		쮂
쮀"		쮉
쮀#		쮖
쮀$		쮎
쮀%		쮍
쮀1		쮛
쮀2		쮔
쮀3		쮑
쮀A		쮇
쮀C		쮘
쮀D		쮋
쮀E		쮅
쮀F		쮊
쮀Q		쮚
쮀R		쮏
쮀S		쮆
쮀T		쮌
쮀V		쮃
쮀W		쮙
쮀X		쮒
쮀Z		쮗
쮀a		쮕
쮀q		쮓
쮀s		쮄
쮀w		쮈
쮀x		쮁
쮀z		쮐
쮜!		쮞
쮜"		쮥
쮜#		쮲
쮜$		쮪
쮜%		쮩
쮜1		쮷
쮜2		쮰
쮜3		쮭
쮜A		쮣
쮜C		쮴
쮜D		쮧
쮜E		쮡
쮜F		쮦
쮜Q		쮶
쮜R		쮫
쮜S		쮢
쮜T		쮨
쮜V		쮟
쮜W		쮵
쮜X		쮮
쮜Z		쮳
쮜a		쮱
쮜q		쮯
쮜s		쮠
쮜w		쮤
쮜x		쮝
쮜z		쮬
쮸!		쮺
쮸"		쯁
쮸#		쯎
쮸$		쯆
쮸%		쯅
쮸1		쯓
쮸2		쯌
쮸3		쯉
쮸A		쮿
쮸C		쯐
쮸D		쯃
쮸E		쮽
쮸F		쯂
쮸Q		쯒
쮸R		쯇
쮸S		쮾
쮸T		쯄
쮸V		쮻
쮸W		쯑
쮸X		쯊
쮸Z		쯏
쮸a		쯍
쮸q		쯋
쮸s		쮼
쮸w		쯀
쮸x		쮹
쮸z		쯈
쯔!		쯖
쯔"		쯝
쯔#		쯪
쯔$		쯢
쯔%		쯡
쯔1		쯯
쯔2		쯨
쯔3		쯥
쯔A		쯛
쯔C		쯬
쯔D		쯟
쯔E		쯙
쯔F		쯞
쯔Q		쯮
쯔R		쯣
쯔S		쯚
쯔T		쯠
쯔V		쯗
쯔W		쯭
쯔X		쯦
쯔Z		쯫
쯔a		쯩
쯔q		쯧
쯔s		쯘
쯔w		쯜
쯔x		쯕
쯔z		쯤
쯰!		쯲
쯰"		쯹
쯰#		찆
쯰$		쯾
쯰%		쯽
쯰1		찋
쯰2		찄
쯰3		찁
쯰A		쯷
쯰C		찈
쯰D		쯻
쯰E		쯵
쯰F		쯺
쯰Q		찊
쯰R		쯿
쯰S		쯶
쯰T		쯼
쯰V		쯳
쯰W		찉
쯰X		찂
쯰Z		찇
쯰a		찅
쯰q		찃
쯰s		쯴
쯰w		쯸
쯰x		쯱
쯰z		찀
찌!		찎
찌"		찕
찌#		찢
찌$		찚
찌%		찙
찌1		찧
찌2		찠
찌3		찝
찌A		찓
찌C		찤
찌D		찗
찌E		찑
찌F		찖
찌Q		찦
찌R		찛
찌S		찒
찌T		찘
찌V		찏
찌W		찥
찌X		찞
찌Z		찣
찌a		찡
찌q		찟
찌s		찐
찌w		찔
찌x		찍
찌z		찜
차!		찪
차"		찱
차#		찾
차$		찶
차%		찵
차1		챃
차2		찼
차3		찹
차A		찯
차C		챀
차D		찳
차E		찭
차F		찲
차Q		챂
차R		찷
차S		찮
차T		찴
차V		찫
차W		챁
차X		찺
차Z		찿
차a		창
차q		찻
차s		찬
차w		찰
차x		착
차z		참
채!		챆
채"		챍
채#		챚
채$		챒
채%		챑
채1		챟
채2		챘
채3		챕
채A		챋
채C		챜
채D		챏
채E		챉
채F		챎
채Q		챞
채R		챓
채S		챊
채T		챐
채V		챇
채W		챝
채X		챖
채Z		챛
채a		챙
채q		챗
채s		챈
채w		챌
채x		책
채z		챔
챠!		챢
챠"		챩
챠#		챶
챠$		챮
챠%		챭
챠1		챻
챠2		챴
챠3		챱
챠A		챧
챠C		챸
챠D		챫
챠E		챥
챠F		챪
챠Q		챺
챠R		챯
챠S		챦
챠T		챬
챠V		챣
챠W		챹
챠X		챲
챠Z		챷
챠a		챵
챠q		챳
챠s		챤
챠w		챨
챠x		챡
챠z		챰
챼!		챾
챼"		첅
챼#		첒
챼$		첊
챼%		첉
챼1		첗
챼2		첐
챼3		첍
챼A		첃
챼C		첔
챼D		첇
챼E		첁
챼F		첆
챼Q		첖
챼R		첋
챼S		첂
챼T		첈
챼V		챿
챼W		첕
챼X		첎
챼Z		첓
챼a		첑
챼q		첏
챼s		첀
챼w		첄
챼x		챽
챼z		첌
처!		첚
처"		첡
처#		첮
처$		첦
처%		첥
처1		첳
처2		첬
처3		첩
처A		첟
처C		첰
처D		첣
처E		첝
처F		첢
처Q		첲
처R		첧
처S		첞
처T		첤
처V		첛
처W		첱
처X		첪
처Z		첯
처a		청
처q		첫
처s		천
처w		철
처x		척
처z		첨
체!		첶
체"		첽
체#		쳊
체$		쳂
체%		쳁
체1		쳏
체2		쳈
체3		쳅
체A		첻
체C		쳌
체D		첿
체E		첹
체F		첾
체Q		쳎
체R		쳃
체S		첺
체T		쳀
체V		첷
체W		쳍
체X		쳆
체Z		쳋
체a		쳉
체q		쳇
체s		첸
체w		첼
체x		첵
체z		쳄
쳐!		쳒
쳐"		쳙
쳐#		쳦
쳐$		쳞
쳐%		쳝
쳐1		쳫
쳐2		쳤
쳐3		쳡
쳐A		쳗
쳐C		쳨
쳐D		쳛
쳐E		쳕
쳐F		쳚
쳐Q		쳪
쳐R		쳟
쳐S		쳖
쳐T		쳜
쳐V		쳓
쳐W		쳩
쳐X		쳢
쳐Z		쳧
쳐a		쳥
쳐q		쳣
쳐s		쳔
쳐w		쳘
쳐x		쳑
쳐z		쳠
쳬!		쳮
쳬"		쳵
쳬#		촂
쳬$		쳺
쳬%		쳹
쳬1		촇
쳬2		촀
쳬3		쳽
쳬A		쳳
쳬C		촄
쳬D		쳷
쳬E		쳱
쳬F		쳶
쳬Q		촆
쳬R		쳻
쳬S		쳲
쳬T		쳸
쳬V		쳯
쳬W		촅
쳬X		쳾
쳬Z		촃
쳬a		촁
쳬q		쳿
쳬s		쳰
쳬w		쳴
쳬x		쳭
쳬z		쳼
초!		촊
초"		촑
초#		촞
초$		촖
초%		촕
초1		촣
초2		촜
초3		촙
초A		촏
초C		촠
초D		촓
초E		촍
초F		촒
초Q		촢
초R		촗
초S		촎
초T		촔
초V		촋
초W		촡
초X		촚
초Z		촟
초a		총
초d		최
초f		촤
초q		촛
초r		쵀
초s		촌
초w		촐
초x		촉
초z		촘
촤!		촦
촤"		촭
촤#		촺
촤$		촲
촤%		촱
촤1		촿
촤2		촸
촤3		촵
촤A		촫
촤C		촼
촤D		촯
촤E		촩
촤F		촮
촤Q		촾
촤R		촳
촤S		촪
촤T		촰
촤V		촧
촤W		촽
촤X		촶
촤Z		촻
촤a		촹
촤q		촷
촤s		촨
촤w		촬
촤x		촥
촤z		촴
쵀!		쵂
쵀"		쵉
쵀#		쵖
쵀$		쵎
쵀%		쵍
쵀1		쵛
쵀2		쵔
쵀3		쵑
쵀A		쵇
쵀C		쵘
쵀D		쵋
쵀E		쵅
쵀F		쵊
쵀Q		쵚
쵀R		쵏
쵀S		쵆
쵀T		쵌
쵀V		쵃
쵀W		쵙
쵀X		쵒
쵀Z		쵗
쵀a		쵕
쵀q		쵓
쵀s		쵄
쵀w		쵈
쵀x		쵁
쵀z		쵐
최!		쵞
최"		쵥
최#		쵲
최$		쵪
최%		쵩
최1		쵷
최2		쵰
최3		쵭
최A		쵣
최C		쵴
최D		쵧
최E		쵡
최F		쵦
최Q		쵶
최R		쵫
최S		쵢
최T		쵨
최V		쵟
최W		쵵
최X		쵮
최Z		쵳
최a		쵱
최q		쵯
최s		쵠
최w		쵤
최x		쵝
최z		쵬
쵸!		쵺
쵸"		춁
쵸#		춎
쵸$		춆
쵸%		춅
쵸1		춓
쵸2		춌
쵸3		춉
쵸A		쵿
쵸C		춐
쵸D		춃
쵸E		쵽
쵸F		춂
쵸Q		춒
쵸R		춇
쵸S		쵾
쵸T		춄
쵸V		쵻
쵸W		춑
쵸X		춊
쵸Z		춏
쵸a		춍
쵸q		춋
쵸s		쵼
쵸w		춀
쵸x		쵹
쵸z		춈
추!		춖
추"		춝
추#		춪
추$		춢
추%		춡
추1		춯
추2		춨
추3		춥
추A		춛
추C		춬
추D		춟
추E		춙
추F		춞
추Q		춮
추R		춣
추S		춚
추T		춠
추V		춗
추W		춭
추X		춦
추Z		춫
추a		충
추c		췌
추d		취
추q		춧
추s		춘
추t		춰
추w		출
추x		축
추z		춤
춰!		춲
춰"		춹
춰#		췆
춰$		춾
춰%		춽
춰1		췋
춰2		췄
춰3		췁
춰A		춷
춰C		췈
춰D		춻
춰E		춵
춰F		춺
춰Q		췊
춰R		춿
춰S		춶
춰T		춼
춰V		춳
춰W		췉
춰X		췂
춰Z		췇
춰a		췅
춰q		췃
춰s		춴
춰w		춸
춰x		춱
춰z		췀
췌!		췎
췌"		췕
췌#		췢
췌$		췚
췌%		췙
췌1		췧
췌2		췠
췌3		췝
췌A		췓
췌C		췤
췌D		췗
췌E		췑
췌F		췖
췌Q		췦
췌R		췛
췌S		췒
췌T		췘
췌V		췏
췌W		췥
췌X		췞
췌Z		췣
췌a		췡
췌q		췟
췌s		췐
췌w		췔
췌x		췍
췌z		췜
취!		췪
취"		췱
취#		췾
취$		췶
취%		췵
취1		츃
취2		췼
취3		췹
취A		췯
취C		츀
취D		췳
취E		췭
취F		췲
취Q		츂
취R		췷
취S		췮
취T		췴
취V		췫
취W		츁
취X		췺
취Z		췿
취a		췽
취q		췻
취s		췬
취w		췰
취x		췩
취z		췸
츄!		츆
츄"		츍
츄#		츚
츄$		츒
츄%		츑
츄1		츟
츄2		츘
츄3		츕
츄A		츋
츄C		츜
츄D		츏
츄E		츉
츄F		츎
츄Q		츞
츄R		츓
츄S		츊
츄T		츐
츄V		츇
츄W		츝
츄X		츖
츄Z		츛
츄a		츙
츄q		츗
츄s		츈
츄w		츌
츄x		츅
츄z		츔
츠!		츢
츠"		츩
츠#		츶
츠$		츮
츠%		츭
츠1		츻
츠2		츴
츠3		츱
츠A		츧
츠C		츸
츠D		츫
츠E		츥
츠F		츪
츠Q		츺
츠R		츯
츠S		츦
츠T		츬
츠V		츣
츠W		츹
츠X		츲
츠Z		츷
츠a		층
츠q		츳
츠s		츤
츠w		츨
츠x		측
츠z		츰
츼!		츾
츼"		칅
츼#		칒
츼$		칊
츼%		칉
츼1		칗
츼2		칐
츼3		칍
츼A		칃
츼C		칔
츼D		칇
츼E		칁
츼F		칆
츼Q		칖
츼R		칋
츼S		칂
츼T		칈
츼V		츿
츼W		칕
츼X		칎
츼Z		칓
츼a		칑
츼q		칏
츼s		칀
츼w		칄
츼x		츽
츼z		칌
치!		칚
치"		칡
치#		칮
치$		칦
치%		칥
치1		칳
치2		칬
치3		칩
치A		칟
치C		칰
치D		칣
치E		칝
치F		칢
치Q		칲
치R		칧
치S		칞
치T		칤
치V		칛
치W		칱
치X		칪
치Z		칯
치a		칭
치q		칫
치s		친
치w		칠
치x		칙
치z		침
카!		칶
카"		칽
카#		캊
카$		캂
카%		캁
카1		캏
카2		캈
카3		캅
카A		칻
카C		캌
카D		칿
카E		칹
카F		칾
카Q		캎
카R		캃
카S		칺
카T		캀
카V		칷
카W		캍
카X		캆
카Z		캋
카a		캉
카q		캇
카s		칸
카w		칼
카x		칵
카z		캄
캐!		캒
캐"		캙
캐#		캦
캐$		캞
캐%		캝
캐1		캫
캐2		캤
캐3		캡
캐A		캗
캐C		캨
캐D		캛
캐E		캕
캐F		캚
캐Q		캪
캐R		캟
캐S		캖
캐T		캜
캐V		캓
캐W		캩
캐X		캢
캐Z		캧
캐a		캥
캐q		캣
캐s		캔
캐w		캘
캐x		캑
캐z		캠
캬!		캮
캬"		캵
캬#		컂
캬$		캺
캬%		캹
캬1		컇
캬2		컀
캬3		캽
캬A		캳
캬C		컄
캬D		캷
캬E		캱
캬F		캶
캬Q		컆
캬R		캻
캬S		캲
캬T		캸
캬V		캯
캬W		컅
캬X		캾
캬Z		컃
캬a		컁
캬q		캿
캬s		캰
캬w		캴
캬x		캭
캬z		캼
컈!		컊
컈"		컑
컈#		컞
컈$		컖
컈%		컕
컈1		컣
컈2		컜
컈3		컙
컈A		컏
컈C		컠
컈D		컓
컈E		컍
컈F		컒
컈Q		컢
컈R		컗
컈S		컎
컈T		컔
컈V		컋
컈W		컡
컈X		컚
컈Z		컟
컈a		컝
컈q		컛
컈s		컌
컈w		컐
컈x		컉
컈z		컘
커!		컦
커"		컭
커#		컺
커$		컲
커%		컱
커1		컿
커2		컸
커3		컵
커A		컫
커C		컼
커D		컯
커E		컩
커F		컮
커Q		컾
커R		컳
커S		컪
커T		컰
커V		컧
커W		컽
커X		컶
커Z		컻
커a		컹
커q		컷
커s		컨
커w		컬
커x		컥
커z		컴
케!		켂
케"		켉
케#		켖
케$		켎
케%		켍
케1		켛
케2		켔
케3		켑
케A		켇
케C		켘
케D		켋
케E		켅
케F		켊
케Q		켚
케R		켏
케S		켆
케T		켌
케V		켃
케W		켙
케X		켒
케Z		켗
케a		켕
케q		켓
케s		켄
케w		켈
케x		켁
케z		켐
켜!		켞
켜"		켥
켜#		켲
켜$		켪
켜%		켩
켜1		켷
켜2		켰
켜3		켭
켜A		켣
켜C		켴
켜D		켧
켜E		켡
켜F		켦
켜Q		켶
켜R		켫
켜S		켢
켜T		켨
켜V		켟
켜W		켵
켜X		켮
켜Z		켳
켜a		켱
켜q		켯
켜s		켠
켜w		켤
켜x		켝
켜z		켬
켸!		켺
켸"		콁
켸#		콎
켸$		콆
켸%		콅
켸1		콓
켸2		콌
켸3		콉
켸A		켿
켸C		콐
켸D		콃
켸E		켽
켸F		콂
켸Q		콒
켸R		콇
켸S		켾
켸T		콄
켸V		켻
켸W		콑
켸X		콊
켸Z		콏
켸a		콍
켸q		콋
켸s		켼
켸w		콀
켸x		켹
켸z		콈
코!		콖
코"		콝
코#		콪
코$		콢
코%		콡
코1		콯
코2		콨
코3		콥
코A		콛
코C		콬
코D		콟
코E		콙
코F		콞
코Q		콮
코R		콣
코S		콚
코T		콠
코V		콗
코W		콭
코X		콦
코Z		콫
코a		콩
코d		쾨
코f		콰
코q		콧
코r		쾌
코s		콘
코w		콜
코x		콕
코z		콤
콰!		콲
콰"		콹
콰#		쾆
콰$		콾
콰%		콽
콰1		쾋
콰2		쾄
콰3		쾁
콰A		콷
콰C		쾈
콰D		콻
콰E		콵
콰F		콺
콰Q		쾊
콰R		콿
콰S		콶
콰T		콼
콰V		콳
콰W		쾉
콰X		쾂
콰Z		쾇
콰a		쾅
콰q		쾃
콰s		콴
콰w		콸
콰x		콱
콰z		쾀
쾌!		쾎
쾌"		쾕
쾌#		쾢
쾌$		쾚
쾌%		쾙
쾌1		쾧
쾌2		쾠
쾌3		쾝
쾌A		쾓
쾌C		쾤
쾌D		쾗
쾌E		쾑
쾌F		쾖
쾌Q		쾦
쾌R		쾛
쾌S		쾒
쾌T		쾘
쾌V		쾏
쾌W		쾥
쾌X		쾞
쾌Z		쾣
쾌a		쾡
쾌q		쾟
쾌s		쾐
쾌w		쾔
쾌x		쾍
쾌z		쾜
쾨!		쾪
쾨"		쾱
쾨#		쾾
쾨$		쾶
쾨%		쾵
쾨1		쿃
쾨2		쾼
쾨3		쾹
쾨A		쾯
쾨C		쿀
쾨D		쾳
쾨E		쾭
쾨F		쾲
쾨Q		쿂
쾨R		쾷
쾨S		쾮
쾨T		쾴
쾨V		쾫
쾨W		쿁
쾨X		쾺
쾨Z		쾿
쾨a		쾽
쾨q		쾻
쾨s		쾬
쾨w		쾰
쾨x		쾩
쾨z		쾸
쿄!		쿆
쿄"		쿍
쿄#		쿚
쿄$		쿒
쿄%		쿑
쿄1		쿟
쿄2		쿘
쿄3		쿕
쿄A		쿋
쿄C		쿜
쿄D		쿏
쿄E		쿉
쿄F		쿎
쿄Q		쿞
쿄R		쿓
쿄S		쿊
쿄T		쿐
쿄V		쿇
쿄W		쿝
쿄X		쿖
쿄Z		쿛
쿄a		쿙
쿄q		쿗
쿄s		쿈
쿄w		쿌
쿄x		쿅
쿄z		쿔
쿠!		쿢
쿠"		쿩
쿠#		쿶
쿠$		쿮
쿠%		쿭
쿠1		쿻
쿠2		쿴
쿠3		쿱
쿠A		쿧
쿠C		쿸
쿠D		쿫
쿠E		쿥
쿠F		쿪
쿠Q		쿺
쿠R		쿯
쿠S		쿦
쿠T		쿬
쿠V		쿣
쿠W		쿹
쿠X		쿲
쿠Z		쿷
쿠a		쿵
쿠c		퀘
쿠d		퀴
쿠q		쿳
쿠s		쿤
쿠t		쿼
쿠w		쿨
쿠x		쿡
쿠z		쿰
쿼!		쿾
쿼"		퀅
쿼#		퀒
쿼$		퀊
쿼%		퀉
쿼1		퀗
쿼2		퀐
쿼3		퀍
쿼A		퀃
쿼C		퀔
쿼D		퀇
쿼E		퀁
쿼F		퀆
쿼Q		퀖
쿼R		퀋
쿼S		퀂
쿼T		퀈
쿼V		쿿
쿼W		퀕
쿼X		퀎
쿼Z		퀓
쿼a		퀑
쿼q		퀏
쿼s		퀀
쿼w		퀄
쿼x		쿽
쿼z		퀌
퀘!		퀚
퀘"		퀡
퀘#		퀮
퀘$		퀦
퀘%		퀥
퀘1		퀳
퀘2		퀬
퀘3		퀩
퀘A		퀟
퀘C		퀰
퀘D		퀣
퀘E		퀝
퀘F		퀢
퀘Q		퀲
퀘R		퀧
퀘S		퀞
퀘T		퀤
퀘V		퀛
퀘W		퀱
퀘X		퀪
퀘Z		퀯
퀘a		퀭
퀘q		퀫
퀘s		퀜
퀘w		퀠
퀘x		퀙
퀘z		퀨
퀴!		퀶
퀴"		퀽
퀴#		큊
퀴$		큂
퀴%		큁
퀴1		큏
퀴2		큈
퀴3		큅
퀴A		퀻
퀴C		큌
퀴D		퀿
퀴E		퀹
퀴F		퀾
퀴Q		큎
퀴R		큃
퀴S		퀺
퀴T		큀
퀴V		퀷
퀴W		큍
퀴X		큆
퀴Z		큋
퀴a		큉
퀴q		큇
퀴s		퀸
퀴w		퀼
퀴x		퀵
퀴z		큄
큐!		큒
큐"		큙
큐#		큦
큐$		큞
큐%		큝
큐1		큫
큐2		큤
큐3		큡
큐A		큗
큐C		큨
큐D		큛
큐E		큕
큐F		큚
큐Q		큪
큐R		큟
큐S		큖
큐T		큜
큐V		큓
큐W		큩
큐X		큢
큐Z		큧
큐a		큥
큐q		큣
큐s		큔
큐w		큘
큐x		큑
큐z		큠
크!		큮
크"		큵
크#		킂
크$		큺
크%		큹
크1		킇
크2		킀
크3		큽
크A		큳
크C		킄
크D		큷
크E		큱
크F		큶
크Q		킆
크R		큻
크S		큲
크T		큸
크V		큯
크W		킅
크X		큾
크Z		킃
크a		킁
크q		큿
크s		큰
크w		클
크x		큭
크z		큼
킈!		킊
킈"		킑
킈#		킞
킈$		킖
킈%		킕
킈1		킣
킈2		킜
킈3		킙
킈A		킏
킈C		킠
킈D		킓
킈E		킍
킈F		킒
킈Q		킢
킈R		킗
킈S		킎
킈T		킔
킈V		킋
킈W		킡
킈X		킚
킈Z		킟
킈a		킝
킈q		킛
킈s		킌
킈w		킐
킈x		킉
킈z		킘
키!		킦
키"		킭
키#		킺
키$		킲
키%		킱
키1		킿
키2		킸
키3		킵
키A		킫
키C		킼
키D		킯
키E		킩
키F		킮
키Q		킾
키R		킳
키S		킪
키T		킰
키V		킧
키W		킽
키X		킶
키Z		킻
키a		킹
키q		킷
키s		킨
키w		킬
키x		킥
키z		킴
타!		탂
타"		탉
타#		탖
타$		탎
타%		탍
타1		탛
타2		탔
타3		탑
타A		탇
타C		탘
타D		탋
타E		탅
타F		탊
타Q		탚
타R		탏
타S		탆
타T		탌
타V		탃
타W		탙
타X		탒
타Z		탗
타a		탕
타q		탓
타s		탄
타w		탈
타x		탁
타z		탐
태!		탞
태"		탥
태#		탲
태$		탪
태%		탩
태1		탷
태2		탰
태3		탭
태A		탣
태C		탴
태D		탧
태E		탡
태F		탦
태Q		탶
태R		탫
태S		탢
태T		탨
태V		탟
태W		탵
태X		탮
태Z		탳
태a		탱
태q		탯
태s		탠
태w		탤
태x		택
태z		탬
탸!		탺
탸"		턁
탸#		턎
탸$		턆
탸%		턅
탸1		턓
탸2		턌
탸3		턉
탸A		탿
탸C		턐
탸D		턃
탸E		탽
탸F		턂
탸Q		턒
탸R		턇
탸S		탾
탸T		턄
탸V		탻
탸W		턑
탸X		턊
탸Z		턏
탸a		턍
탸q		턋
탸s		탼
탸w		턀
탸x		탹
탸z		턈
턔!		턖
턔"		턝
턔#		턪
턔$		턢
턔%		턡
턔1		턯
턔2		턨
턔3		턥
턔A		턛
턔C		턬
턔D		턟
턔E		턙
턔F		턞
턔Q		턮
턔R		턣
턔S		턚
턔T		턠
턔V		턗
턔W		턭
턔X		턦
턔Z		턫
턔a		턩
턔q		턧
턔s		턘
턔w		턜
턔x		턕
턔z		턤
터!		턲
터"		턹
터#		텆
터$		턾
터%		턽
터1		텋
터2		텄
터3		텁
터A		턷
터C		텈
터D		턻
터E		턵
터F		턺
터Q		텊
터R		턿
터S		턶
터T		턼
터V		턳
터W		텉
터X		텂
터Z		텇
터a		텅
터q		텃
터s		턴
터w		털
터x		턱
터z		텀
테!		텎
테"		텕
테#		텢
테$		텚
테%		텙
테1		텧
테2		텠
테3		텝
테A		텓
테C		텤
테D		텗
테E		텑
테F		텖
테Q		텦
테R		텛
테S		텒
테T		텘
테V		텏
테W		텥
테X		텞
테Z		텣
테a		텡
테q		텟
테s		텐
테w		텔
테x		텍
테z		템
텨!		텪
텨"		텱
텨#		텾
텨$		텶
텨%		텵
텨1		톃
텨2		텼
텨3		텹
텨A		텯
텨C		톀
텨D		텳
텨E		텭
텨F		텲
텨Q		톂
텨R		텷
텨S		텮
텨T		텴
텨V		텫
텨W		톁
텨X		텺
텨Z		텿
텨a		텽
텨q		텻
텨s		텬
텨w		텰
텨x		텩
텨z		텸
톄!		톆
톄"		톍
톄#		톚
톄$		톒
톄%		톑
톄1		톟
톄2		톘
톄3		톕
톄A		톋
톄C		톜
톄D		톏
톄E		톉
톄F		톎
톄Q		톞
톄R		톓
톄S		톊
톄T		톐
톄V		톇
톄W		톝
톄X		톖
톄Z		톛
톄a		톙
톄q		톗
톄s		톈
톄w		톌
톄x		톅
톄z		톔
토!		톢
토"		톩
토#		톶
토$		톮
토%		톭
토1		톻
토2		톴
토3		톱
토A		톧
토C		톸
토D		톫
토E		톥
토F		톪
토Q		톺
토R		톯
토S		톦
토T		톬
토V		톣
토W		톹
토X		톲
토Z		톷
토a		통
토d		퇴
토f		톼
토q		톳
토r		퇘
토s		톤
토w		톨
토x		톡
토z		톰
톼!		톾
톼"		퇅
톼#		퇒
톼$		퇊
톼%		퇉
톼1		퇗
톼2		퇐
톼3		퇍
톼A		퇃
톼C		퇔
톼D		퇇
톼E		퇁
톼F		퇆
톼Q		퇖
톼R		퇋
톼S		퇂
톼T		퇈
톼V		톿
톼W		퇕
톼X		퇎
톼Z		퇓
톼a		퇑
톼q		퇏
톼s		퇀
톼w		퇄
톼x		톽
톼z		퇌
퇘!		퇚
퇘"		퇡
퇘#		퇮
퇘$		퇦
퇘%		퇥
퇘1		퇳
퇘2		퇬
퇘3		퇩
퇘A		퇟
퇘C		퇰
퇘D		퇣
퇘E		퇝
퇘F		퇢
퇘Q		퇲
퇘R		퇧
퇘S		퇞
퇘T		퇤
퇘V		퇛
퇘W		퇱
퇘X		퇪
퇘Z		퇯
퇘a		퇭
퇘q		퇫
퇘s		퇜
퇘w		퇠
퇘x		퇙
퇘z		퇨
퇴!		퇶
퇴"		퇽
퇴#		툊
퇴$		툂
퇴%		툁
퇴1		툏
퇴2		툈
퇴3		툅
퇴A		퇻
퇴C		툌
퇴D		퇿
퇴E		퇹
퇴F		퇾
퇴Q		툎
퇴R		툃
퇴S		퇺
퇴T		툀
퇴V		퇷
퇴W		툍
퇴X		툆
퇴Z		툋
퇴a		툉
퇴q		툇
퇴s		퇸
퇴w		퇼
퇴x		퇵
퇴z		툄
툐!		툒
툐"		툙
툐#		툦
툐$		툞
툐%		툝
툐1		툫
툐2		툤
툐3		툡
툐A		툗
툐C		툨
툐D		툛
툐E		툕
툐F		툚
툐Q		툪
툐R		툟
툐S		툖
툐T		툜
툐V		툓
툐W		툩
툐X		툢
툐Z		툧
툐a		툥
툐q		툣
툐s		툔
툐w		툘
툐x		툑
툐z		툠
투!		툮
투"		툵
투#		퉂
투$		툺
투%		툹
투1		퉇
투2		퉀
투3		툽
투A		툳
투C		퉄
투D		툷
투E		툱
투F		툶
투Q		퉆
투R		툻
투S		툲
투T		툸
투V		툯
투W		퉅
투X		툾
투Z		퉃
투a		퉁
투c		퉤
투d		튀
투q		툿
투s		툰
투t		퉈
투w		툴
투x		툭
투z		툼
퉈!		퉊
퉈"		퉑
퉈#		퉞
퉈$		퉖
퉈%		퉕
퉈1		퉣
퉈2		퉜
퉈3		퉙
퉈A		퉏
퉈C		퉠
퉈D		퉓
퉈E		퉍
퉈F		퉒
퉈Q		퉢
퉈R		퉗
퉈S		퉎
퉈T		퉔
퉈V		퉋
퉈W		퉡
퉈X		퉚
퉈Z		퉟
퉈a		퉝
퉈q		퉛
퉈s		퉌
퉈w		퉐
퉈x		퉉
퉈z		퉘
퉤!		퉦
퉤"		퉭
퉤#		퉺
퉤$		퉲
퉤%		퉱
퉤1		퉿
퉤2		퉸
퉤3		퉵
퉤A		퉫
퉤C		퉼
퉤D		퉯
퉤E		퉩
퉤F		퉮
퉤Q		퉾
퉤R		퉳
퉤S		퉪
퉤T		퉰
퉤V		퉧
퉤W		퉽
퉤X		퉶
퉤Z		퉻
퉤a		퉹
퉤q		퉷
퉤s		퉨
퉤w		퉬
퉤x		퉥
퉤z		퉴
튀!		튂
튀"		튉
튀#		튖
튀$		튎
튀%		튍
튀1		튛
튀2		튔
튀3		튑
튀A		튇
튀C		튘
튀D		튋
튀E		튅
튀F		튊
튀Q		튚
튀R		튏
튀S		튆
튀T		튌
튀V		튃
튀W		튙
튀X		튒
튀Z		튗
튀a		튕
튀q		튓
튀s		튄
튀w		튈
튀x		튁
튀z		튐
튜!		튞
튜"		튥
튜#		튲
튜$		튪
튜%		튩
튜1		튷
튜2		튰
튜3		튭
튜A		튣
튜C		튴
튜D		튧
튜E		튡
튜F		튦
튜Q		튶
튜R		튫
튜S		튢
튜T		튨
튜V		튟
튜W		튵
튜X		튮
튜Z		튳
튜a		튱
튜q		튯
튜s		튠
튜w		튤
튜x		튝
튜z		튬
트!		튺
트"		틁
트#		틎
트$		틆
트%		틅
트1		틓
트2		틌
트3		틉
트A		튿
트C		틐
트D		틃
트E		튽
트F		틂
트Q		틒
트R		틇
트S		튾
트T		틄
트V		튻
트W		틑
트X		틊
트Z		틏
트a		틍
트q		틋
트s		튼
트w		틀
트x		특
트z		틈
틔!		틖
틔"		틝
틔#		틪
틔$		틢
틔%		틡
틔1		틯
틔2		틨
틔3		틥
틔A		틛
틔C		틬
틔D		틟
틔E		틙
틔F		틞
틔Q		틮
틔R		틣
틔S		틚
틔T		틠
틔V		틗
틔W		틭
틔X		틦
틔Z		틫
틔a		틩
틔q		틧
틔s		틘
틔w		틜
틔x		틕
틔z		틤
티!		틲
티"		틹
티#		팆
티$		틾
티%		틽
티1		팋
티2		팄
티3		팁
티A		틷
티C		팈
티D		틻
티E		틵
티F		틺
티Q		팊
티R		틿
티S		틶
티T		틼
티V		틳
티W		팉
티X		팂
티Z		팇
티a		팅
티q		팃
티s		틴
티w		틸
티x		틱
티z		팀
파!		팎
파"		팕
파#		팢
파$		팚
파%		팙
파1		팧
파2		팠
파3		팝
파A		팓
파C		팤
파D		팗
파E		팑
파F		팖
파Q		팦
파R		팛
파S		팒
파T		팘
파V		팏
파W		팥
파X		팞
파Z		팣
파a		팡
파q		팟
파s		판
파w		팔
파x		팍
파z		팜
패!		팪
패"		팱
패#		팾
패$		팶
패%		팵
패1		퍃
패2		팼
패3		팹
패A		팯
패C		퍀
패D		팳
패E		팭
패F		팲
패Q		퍂
패R		팷
패S		팮
패T		팴
패V		팫
패W		퍁
패X		팺
패Z		팿
패a		팽
패q		팻
패s		팬
패w		팰
패x		팩
패z		팸
퍄!		퍆
퍄"		퍍
퍄#		퍚
퍄$		퍒
퍄%		퍑
퍄1		퍟
퍄2		퍘
퍄3		퍕
퍄A		퍋
퍄C		퍜
퍄D		퍏
퍄E		퍉
퍄F		퍎
퍄Q		퍞
퍄R		퍓
퍄S		퍊
퍄T		퍐
퍄V		퍇
퍄W		퍝
퍄X		퍖
퍄Z		퍛
퍄a		퍙
퍄q		퍗
퍄s		퍈
퍄w		퍌
퍄x		퍅
퍄z		퍔
퍠!		퍢
퍠"		퍩
퍠#		퍶
퍠$		퍮
퍠%		퍭
퍠1		퍻
퍠2		퍴
퍠3		퍱
퍠A		퍧
퍠C		퍸
퍠D		퍫
퍠E		퍥
퍠F		퍪
퍠Q		퍺
퍠R		퍯
퍠S		퍦
퍠T		퍬
퍠V		퍣
퍠W		퍹
퍠X		퍲
퍠Z		퍷
퍠a		퍵
퍠q		퍳
퍠s		퍤
퍠w		퍨
퍠x		퍡
퍠z		퍰
퍼!		퍾
퍼"		펅
퍼#		펒
퍼$		펊
퍼%		펉
퍼1		펗
퍼2		펐
퍼3		펍
퍼A		펃
퍼C		펔
퍼D		펇
퍼E		펁
퍼F		펆
퍼Q		펖
퍼R		펋
퍼S		펂
퍼T		펈
퍼V		퍿
퍼W		펕
퍼X		펎
퍼Z		펓
퍼a		펑
퍼q		펏
퍼s		펀
퍼w		펄
퍼x		퍽
퍼z		펌
페!		펚
페"		펡
페#		펮
페$		펦
페%		펥
페1		펳
페2		펬
페3		펩
페A		펟
페C		펰
페D		펣
페E		펝
페F		펢
페Q		펲
페R		펧
페S		펞
페T		펤
페V		펛
페W		펱
페X		펪
페Z		펯
페a		펭
페q		펫
페s		펜
페w		펠
페x		펙
페z		펨
펴!		펶
펴"		펽
펴#		폊
펴$		폂
펴%		폁
펴1		폏
펴2		폈
펴3		폅
펴A		펻
펴C		폌
펴D		펿
펴E		펹
펴F		펾
펴Q		폎
펴R		폃
펴S		펺
펴T		폀
펴V		펷
펴W		폍
펴X		폆
펴Z		폋
펴a		평
펴q		폇
펴s		편
펴w		펼
펴x		펵
펴z		폄
폐!		폒
폐"		폙
폐#		폦
폐$		폞
폐%		폝
폐1		폫
폐2		폤
폐3		폡
폐A		폗
폐C		폨
폐D		폛
폐E		폕
폐F		폚
폐Q		폪
폐R		폟
폐S		폖
폐T		폜
폐V		폓
폐W		폩
폐X		폢
폐Z		폧
폐a		폥
폐q		폣
폐s		폔
폐w		폘
폐x		폑
폐z		폠
포!		폮
포"		폵
포#		퐂
포$		폺
포%		폹
포1		퐇
포2		퐀
포3		폽
포A		폳
포C		퐄
포D		폷
포E		폱
포F		폶
포Q		퐆
포R		폻
포S		폲
포T		폸
포V		폯
포W		퐅
포X		폾
포Z		퐃
포a		퐁
포d		푀
포f		퐈
포q		폿
포r		퐤
포s		폰
포w		폴
포x		폭
포z		폼
퐈!		퐊
퐈"		퐑
퐈#		퐞
퐈$		퐖
퐈%		퐕
퐈1		퐣
퐈2		퐜
퐈3		퐙
퐈A		퐏
퐈C		퐠
퐈D		퐓
퐈E		퐍
퐈F		퐒
퐈Q		퐢
퐈R		퐗
퐈S		퐎
퐈T		퐔
퐈V		퐋
퐈W		퐡
퐈X		퐚
퐈Z		퐟
퐈a		퐝
퐈q		퐛
퐈s		퐌
퐈w		퐐
퐈x		퐉
퐈z		퐘
퐤!		퐦
퐤"		퐭
퐤#		퐺
퐤$		퐲
퐤%		퐱
퐤1		퐿
퐤2		퐸
퐤3		퐵
퐤A		퐫
퐤C		퐼
퐤D		퐯
퐤E		퐩
퐤F		퐮
퐤Q		퐾
퐤R		퐳
퐤S		퐪
퐤T		퐰
퐤V		퐧
퐤W		퐽
퐤X		퐶
퐤Z		퐻
퐤a		퐹
퐤q		퐷
퐤s		퐨
퐤w		퐬
퐤x		퐥
퐤z		퐴
푀!		푂
푀"		푉
푀#		푖
푀$		푎
푀%		푍
푀1		푛
푀2		푔
푀3		푑
푀A		푇
푀C		푘
푀D		푋
푀E		푅
푀F		푊
푀Q		푚
푀R		푏
푀S		푆
푀T		푌
푀V		푃
푀W		푙
푀X		푒
푀Z		푗
푀a		푕
푀q		푓
푀s		푄
푀w		푈
푀x		푁
푀z		푐
표!		푞
표"		푥
표#		푲
표$		푪
표%		푩
표1		푷
표2		푰
표3		푭
표A		푣
표C		푴
표D		푧
표E		푡
표F		푦
표Q		푶
표R		푫
표S		푢
표T		푨
표V		푟
표W		푵
표X		푮
표Z		푳
표a		푱
표q		푯
표s		푠
표w		푤
표x		푝
표z		푬
푸!		푺
푸"		풁
푸#		풎
푸$		풆
푸%		풅
푸1		풓
푸2		풌
푸3		풉
푸A		푿
푸C		풐
푸D		풃
푸E		푽
푸F		풂
푸Q		풒
푸R		풇
푸S		푾
푸T		풄
푸V		푻
푸W		풑
푸X		풊
푸Z		풏
푸a		풍
푸c		풰
푸d		퓌
푸q		풋
푸s		푼
푸t		풔
푸w		풀
푸x		푹
푸z		품
풔!		풖
풔"		풝
풔#		풪
풔$		풢
풔%		풡
풔1		풯
풔2		풨
풔3		풥
풔A		풛
풔C		풬
풔D		풟
풔E		풙
풔F		풞
풔Q		풮
풔R		풣
풔S		풚
풔T		풠
풔V		풗
풔W		풭
풔X		풦
풔Z		풫
풔a		풩
풔q		풧
풔s		풘
풔w		풜
풔x		풕
풔z		풤
풰!		풲
풰"		풹
풰#		퓆
풰$		풾
풰%		풽
풰1		퓋
풰2		퓄
풰3		퓁
풰A		풷
풰C		퓈
풰D		풻
풰E		풵
풰F		풺
풰Q		퓊
풰R		풿
풰S		풶
풰T		풼
풰V		풳
풰W		퓉
풰X		퓂
풰Z		퓇
풰a		퓅
풰q		퓃
풰s		풴
풰w		풸
풰x		풱
풰z		퓀
퓌!		퓎
퓌"		퓕
퓌#		퓢
퓌$		퓚
퓌%		퓙
퓌1		퓧
퓌2		퓠
퓌3		퓝
퓌A		퓓
퓌C		퓤
퓌D		퓗
퓌E		퓑
퓌F		퓖
퓌Q		퓦
퓌R		퓛
퓌S		퓒
퓌T		퓘
퓌V		퓏
퓌W		퓥
퓌X		퓞
퓌Z		퓣
퓌a		퓡
퓌q		퓟
퓌s		퓐
퓌w		퓔
퓌x		퓍
퓌z		퓜
퓨!		퓪
퓨"		퓱
퓨#		퓾
퓨$		퓶
퓨%		퓵
퓨1		픃
퓨2		퓼
퓨3		퓹
퓨A		퓯
퓨C		픀
퓨D		퓳
퓨E		퓭
퓨F		퓲
퓨Q		픂
퓨R		퓷
퓨S		퓮
퓨T		퓴
퓨V		퓫
퓨W		픁
퓨X		퓺
퓨Z		퓿
퓨a		퓽
퓨q		퓻
퓨s		퓬
퓨w		퓰
퓨x		퓩
퓨z		퓸
프!		픆
프"		픍
프#		픚
프$		픒
프%		픑
프1		픟
프2		픘
프3		픕
프A		픋
프C		픜
프D		픏
프E		픉
프F		픎
프Q		픞
프R		픓
프S		픊
프T		픐
프V		픇
프W		픝
프X		픖
프Z		픛
프a		픙
프q		픗
프s		픈
프w		플
프x		픅
프z		픔
픠!		픢
픠"		픩
픠#		픶
픠$		픮
픠%		픭
픠1		픻
픠2		픴
픠3		픱
픠A		픧
픠C		픸
픠D		픫
픠E		픥
픠F		픪
픠Q		픺
픠R		픯
픠S		픦
픠T		픬
픠V		픣
픠W		픹
픠X		픲
픠Z		픷
픠a		픵
픠q		픳
픠s		픤
픠w		픨
픠x		픡
픠z		픰
피!		픾
피"		핅
피#		핒
피$		핊
피%		핉
피1		핗
피2		핐
피3		핍
피A		핃
피C		핔
피D		핇
피E		핁
피F		핆
피Q		핖
피R		핋
피S		핂
피T		핈
피V		픿
피W		핕
피X		핎
피Z		핓
피a		핑
피q		핏
피s		핀
피w		필
피x		픽
피z		핌
하!		핚
하"		핡
하#		핮
하$		핦
하%		핥
하1		핳
하2		핬
하3		합
하A		핟
하C		핰
하D		핣
하E		핝
하F		핢
하Q		핲
하R		핧
하S		핞
하T		핤
하V		핛
하W		핱
하X		핪
하Z		핯
하a		항
하q		핫
하s		한
하w		할
하x		학
하z		함
해!		핶
해"		핽
해#		햊
해$		햂
해%		햁
해1		햏
해2		했
해3		햅
해A		핻
해C		햌
해D		핿
해E		핹
해F		핾
해Q		햎
해R		햃
해S		핺
해T		햀
해V		핷
해W		햍
해X		햆
해Z		햋
해a		행
해q		햇
해s		핸
해w		핼
해x		핵
해z		햄
햐!		햒
햐"		햙
햐#		햦
햐$		햞
햐%		햝
햐1		햫
햐2		햤
햐3		햡
햐A		햗
햐C		햨
햐D		햛
햐E		햕
햐F		햚
햐Q		햪
햐R		햟
햐S		햖
햐T		햜
햐V		햓
햐W		햩
햐X		햢
햐Z		햧
햐a		향
햐q		햣
햐s		햔
햐w		햘
햐x		햑
햐z		햠
햬!		햮
햬"		햵
햬#		헂
햬$		햺
햬%		햹
햬1		헇
햬2		헀
햬3		햽
햬A		햳
햬C		헄
햬D		햷
햬E		햱
햬F		햶
햬Q		헆
햬R		햻
햬S		햲
햬T		햸
햬V		햯
햬W		헅
햬X		햾
햬Z		헃
햬a		헁
햬q		햿
햬s		햰
햬w		햴
햬x		햭
햬z		햼
허!		헊
허"		헑
허#		헞
허$		헖
허%		헕
허1		헣
허2		헜
허3		헙
허A		헏
허C		헠
허D		헓
허E		헍
허F		헒
허Q		헢
허R		헗
허S		헎
허T		헔
허V		헋
허W		헡
허X		헚
허Z		헟
허a		헝
허q		헛
허s		헌
허w		헐
허x		헉
허z		험
헤!		헦
헤"		헭
헤#		헺
헤$		헲
헤%		헱
헤1		헿
헤2		헸
헤3		헵
헤A		헫
헤C		헼
헤D		헯
헤E		헩
헤F		헮
헤Q		헾
헤R		헳
헤S		헪
헤T		헰
헤V		헧
헤W		헽
헤X		헶
헤Z		헻
헤a		헹
헤q		헷
헤s		헨
헤w		헬
헤x		헥
헤z		헴
혀!		혂
혀"		혉
혀#		혖
혀$		혎
혀%		혍
혀1		혛
혀2		혔
혀3		협
혀A		혇
혀C		혘
혀D		혋
혀E		혅
혀F		혊
혀Q		혚
혀R		혏
혀S		혆
혀T		혌
혀V		혃
혀W		혙
혀X		혒
혀Z		혗
혀a		형
혀q		혓
혀s		현
혀w		혈
혀x		혁
혀z		혐
혜!		혞
혜"		혥
혜#		혲
혜$		혪
혜%		혩
혜1		혷
혜2		혰
혜3		혭
혜A		혣
혜C		혴
혜D		혧
혜E		혡
혜F		혦
혜Q		혶
혜R		혫
혜S		혢
혜T		혨
혜V		혟
혜W		혵
혜X		혮
혜Z		혳
혜a		혱
혜q		혯
혜s		혠
혜w		혤
혜x		혝
혜z		혬
호!		혺
호"		홁
호#		홎
호$		홆
호%		홅
호1		홓
호2		홌
호3		홉
호A		혿
호C		홐
호D		홃
호E		혽
호F		홂
호Q		홒
호R		홇
호S		혾
호T		홄
호V		혻
호W		홑
호X		홊
호Z		홏
호a		홍
호d		회
호f		화
호q		홋
호r		홰
호s		혼
호w		홀
호x		혹
호z		홈
화!		홖
화"		홝
화#		홪
화$		홢
화%		홡
화1		홯
화2		홨
화3		홥
화A		홛
화C		홬
화D		홟
화E		홙
화F		홞
화Q		홮
화R		홣
화S		홚
화T		홠
화V		홗
화W		홭
화X		홦
화Z		홫
화a		황
화q		홧
화s		환
화w		활
화x		확
화z		홤
홰!		홲
홰"		홹
홰#		횆
홰$		홾
홰%		홽
홰1		횋
홰2		횄
홰3		횁
홰A		홷
홰C		횈
홰D		홻
홰E		홵
홰F		홺
홰Q		횊
홰R		홿
홰S		홶
홰T		홼
홰V		홳
홰W		횉
홰X		횂
홰Z		횇
홰a		횅
홰q		횃
홰s		홴
홰w		홸
홰x		홱
홰z		횀
회!		횎
회"		횕
회#		횢
회$		횚
회%		횙
회1		횧
회2		횠
회3		횝
회A		횓
회C		횤
회D		횗
회E		횑
회F		횖
회Q		횦
회R		횛
회S		횒
회T		횘
회V		횏
회W		횥
회X		횞
회Z		횣
회a		횡
회q		횟
회s		횐
회w		횔
회x		획
회z		횜
효!		횪
효"		횱
효#		횾
효$		횶
효%		횵
효1		훃
효2		횼
효3		횹
효A		횯
효C		훀
효D		횳
효E		횭
효F		횲
효Q		훂
효R		횷
효S		횮
효T		횴
효V		횫
효W		훁
효X		횺
효Z		횿
효a		횽
효q		횻
효s		횬
효w		횰
효x		횩
효z		횸
후!		훆
후"		훍
후#		훚
후$		훒
후%		훑
후1		훟
후2		훘
후3		훕
후A		훋
후C		훜
후D		훏
후E		훉
후F		훎
후Q		훞
후R		훓
후S		훊
후T		훐
후V		훇
후W		훝
후X		훖
후Z		훛
후a		훙
후c		훼
후d		휘
후q		훗
후s		훈
후t		훠
후w		훌
후x		훅
후z		훔
훠!		훢
훠"		훩
훠#		훶
훠$		훮
훠%		훭
훠1		훻
훠2		훴
훠3		훱
훠A		훧
훠C		훸
훠D		훫
훠E		훥
훠F		훪
훠Q		훺
훠R		훯
훠S		훦
훠T		훬
훠V		훣
훠W		훹
훠X		훲
훠Z		훷
훠a		훵
훠q		훳
훠s		훤
훠w		훨
훠x		훡
훠z		훰
훼!		훾
훼"		휅
훼#		휒
훼$		휊
훼%		휉
훼1		휗
훼2		휐
훼3		휍
훼A		휃
훼C		휔
훼D		휇
훼E		휁
훼F		휆
훼Q		휖
훼R		휋
훼S		휂
훼T		휈
훼V		훿
훼W		휕
훼X		휎
훼Z		휓
훼a		휑
훼q		휏
훼s		휀
훼w		휄
훼x		훽
훼z		휌
휘!		휚
휘"		휡
휘#		휮
휘$		휦
휘%		휥
휘1		휳
휘2		휬
휘3		휩
휘A		휟
휘C		휰
휘D		휣
휘E		휝
휘F		휢
휘Q		휲
휘R		휧
휘S		휞
휘T		휤
휘V		휛
휘W		휱
휘X		휪
휘Z		휯
휘a		휭
휘q		휫
휘s		휜
휘w		휠
휘x		휙
휘z		휨
휴!		휶
휴"		휽
휴#		흊
휴$		흂
휴%		흁
휴1		흏
휴2		흈
휴3		흅
휴A		휻
휴C		흌
휴D		휿
휴E		휹
휴F		휾
휴Q		흎
휴R		흃
휴S		휺
휴T		흀
휴V		휷
휴W		흍
휴X		흆
휴Z		흋
휴a		흉
휴q		흇
휴s		휸
휴w		휼
휴x		휵
휴z		흄
흐!		흒
흐"		흙
흐#		흦
흐$		흞
흐%		흝
흐1		흫
흐2		흤
흐3		흡
흐A		흗
흐C		흨
흐D		흛
흐E		흕
흐F		흚
흐Q		흪
흐R		흟
흐S		흖
흐T		흜
흐V		흓
흐W		흩
흐X		흢
흐Z		흧
흐a		흥
흐q		흣
흐s		흔
흐w		흘
흐x		흑
흐z		흠
희!		흮
희"		흵
희#		힂
희$		흺
희%		흹
희1		힇
희2		힀
희3		흽
희A		흳
희C		힄
희D		흷
희E		흱
희F		흶
희Q		힆
희R		흻
희S		흲
희T		흸
희V		흯
희W		힅
희X		흾
희Z		힃
희a		힁
희q		흿
희s		흰
희w		흴
희x		흭
희z		흼
히!		힊
히"		힑
히#		힞
히$		힖
히%		힕
히1		힣
히2		힜
히3		힙
히A		힏
히C		힠
히D		힓
히E		힍
히F		힒
히Q		힢
히R		힗
히S		힎
히T		힔
히V		힋
히W		힡
히X		힚
히Z		힟
히a		힝
히q		힛
히s		힌
히w		힐
히x		힉
히z		힘
